AAAAACTCAACTATAACGT -> AAAACTCAACTATAACGTT
AAAAATACGGTTCCACATA -> AAAATACGGTTCCACATAA
AAAAATAGTCAATGCCCCT -> AAAATAGTCAATGCCCCTG
AAAAATAGTCACCTGTGGC -> AAAATAGTCACCTGTGGCG
AAAAATAGTCACTTGCACT -> AAAATAGTCACTTGCACTC
AAAAATAGTCAGGCAGACG -> AAAATAGTCAGGCAGACGT
AAAACACGCAGGAGTCCGG -> AAACACGCAGGAGTCCGGG
AAAACCAAATTCGGAACCC -> AAACCAAATTCGGAACCCC
AAAACCGGAGGCGAAATGG -> AAACCGGAGGCGAAATGGA
AAAACCTGCGTAGAAGTTC -> AAACCTGCGTAGAAGTTCC
AAAACGTGTTGACTATTGC -> AAACGTGTTGACTATTGCT
AAAACTCAACTATAACGTT -> AAACTCAACTATAACGTTA
AAAATACGGTTCCACATAA -> AAATACGGTTCCACATAAT
AAAATAGTCAATGCCCCTG -> AAATAGTCAATGCCCCTGG
AAAATAGTCACCTGTGGCG -> AAATAGTCACCTGTGGCGG
AAAATAGTCACTTGCACTC -> AAATAGTCACTTGCACTCC
AAAATAGTCAGGCAGACGT -> AAATAGTCAGGCAGACGTC
AAAATCTAGAGTACGTTCG -> AAATCTAGAGTACGTTCGG
AAACACGCAGGAGTCCGGG -> AACACGCAGGAGTCCGGGC
AAACATGAGGCGTATGAGT -> AACATGAGGCGTATGAGTC
AAACCAAATTCGGAACCCC -> AACCAAATTCGGAACCCCG
AAACCGAATGACATCTCCT -> AACCGAATGACATCTCCTG
AAACCGGAGGCGAAATGGA -> AACCGGAGGCGAAATGGAA
AAACCTGCGTAGAAGTTCC -> AACCTGCGTAGAAGTTCCC
AAACGGGCATATATCCGCA -> AACGGGCATATATCCGCAG
AAACGGGCATCGGCGAGGT -> AACGGGCATCGGCGAGGTT
AAACGGGCATGGGAGAGCG -> AACGGGCATGGGAGAGCGC
AAACGGGCATTATGTGTCT -> AACGGGCATTATGTGTCTA
AAACGTGTTGACTATTGCT -> AACGTGTTGACTATTGCTT
AAACTAAACTTTAGTACGC -> AACTAAACTTTAGTACGCA
AAACTCAACTATAACGTTA -> AACTCAACTATAACGTTAC
AAACTTTAGTACGCAGCAA -> AACTTTAGTACGCAGCAAT
AAAGATCTTCAAAACCTGC -> AAGATCTTCAAAACCTGCG
AAAGCACCTTGCGCGATTC -> AAGCACCTTGCGCGATTCC
AAAGCTTGCACGGCATGCT -> AAGCTTGCACGGCATGCTC
AAAGGGCGAAAACCAAATT -> AAGGGCGAAAACCAAATTC
AAAGTACACGCACAATTGT -> AAGTACACGCACAATTGTA
AAATACGGTTCCACATAAT -> AATACGGTTCCACATAATA
AAATAGTCAATGCCCCTGG -> AATAGTCAATGCCCCTGGG
AAATAGTCACCTGTGGCGG -> AATAGTCACCTGTGGCGGT
AAATAGTCACTTGCACTCC -> AATAGTCACTTGCACTCCT
AAATAGTCAGGCAGACGTC -> AATAGTCAGGCAGACGTCT
AAATCTAGAGTACGTTCGG -> AATCTAGAGTACGTTCGGC
AAATCTGTCGGTTAGCCCT -> AATCTGTCGGTTAGCCCTT
AAATGACACCGATAGTTGA -> AATGACACCGATAGTTGAC
AAATGATTGGATAAAAACT -> AATGATTGGATAAAAACTC
AAATGCTAGCCGTCGAGCC -> AATGCTAGCCGTCGAGCCC
AAATGGAATTCATAGCGTC -> AATGGAATTCATAGCGTCA
AAATTCGGAACCCCGCGGG -> AATTCGGAACCCCGCGGGG
AAATTTAACCTCCTCAGTT -> AATTTAACCTCCTCAGTTT
AACAATTCTTTAGATGTGC -> ACAATTCTTTAGATGTGCC
AACACGCAGGAGTCCGGGC -> ACACGCAGGAGTCCGGGCT
AACAGAAAATCTAGAGTAC -> ACAGAAAATCTAGAGTACG
AACAGCGTTCAAAAATACG -> ACAGCGTTCAAAAATACGG
AACATGAGGCGTATGAGTC -> ACATGAGGCGTATGAGTCA
AACCAAAGTACACGCACAA -> ACCAAAGTACACGCACAAT
AACCAAATTCGGAACCCCG -> ACCAAATTCGGAACCCCGC
AACCCCGCGGGGGTCAACG -> ACCCCGCGGGGGTCAACGC
AACCCGTTCCACGCGGACC -> ACCCGTTCCACGCGGACCT
AACCCTTGCCTGAAACGGG -> ACCCTTGCCTGAAACGGGC
AACCGAATGACATCTCCTG -> ACCGAATGACATCTCCTGC
AACCGGAGGCGAAATGGAA -> ACCGGAGGCGAAATGGAAT
AACCTCCTCAGTTTTTTCG -> ACCTCCTCAGTTTTTTCGG
AACCTGCGTAGAAGTTCCC -> ACCTGCGTAGAAGTTCCCA
AACGAACCCTTGCCTGAAA -> ACGAACCCTTGCCTGAAAC
AACGACACAACTGGACTTA -> ACGACACAACTGGACTTAG
AACGCATCCTTGACTGTTG -> ACGCATCCTTGACTGTTGG
AACGCCGATGTCCTGCCTG -> ACGCCGATGTCCTGCCTGT
AACGGAAGAGTCATCGTCT -> ACGGAAGAGTCATCGTCTG
AACGGGCATATATCCGCAG -> ACGGGCATATATCCGCAGA
AACGGGCATCGGCGAGGTT -> ACGGGCATCGGCGAGGTTC
AACGGGCATGGGAGAGCGC -> ACGGGCATGGGAGAGCGCT
AACGGGCATTATGTGTCTA -> ACGGGCATTATGTGTCTAG
AACGGTTGCTTGTGTGGAA -> ACGGTTGCTTGTGTGGAAT
AACGTGTTGACTATTGCTT -> ACGTGTTGACTATTGCTTG
AACGTTACCACTTGACAAG -> ACGTTACCACTTGACAAGT
AACTAAACTTTAGTACGCA -> ACTAAACTTTAGTACGCAG
AACTAAGTGAGGCAGGATT -> ACTAAGTGAGGCAGGATTC
AACTATAACGTTACCACTT -> ACTATAACGTTACCACTTG
AACTCAACTATAACGTTAC -> ACTCAACTATAACGTTACC
AACTCCGGTGTCTCTTCGC -> ACTCCGGTGTCTCTTCGCC
AACTCTAAATGCTAGCCGT -> ACTCTAAATGCTAGCCGTC
AACTCTACCACTTTTGGGG -> ACTCTACCACTTTTGGGGA
AACTGCTATTCTATCACGC -> ACTGCTATTCTATCACGCT
AACTGGACTTAGGGATGAC -> ACTGGACTTAGGGATGACA
AACTTGCCTGAAACGGGCA -> ACTTGCCTGAAACGGGCAT
AACTTTAGTACGCAGCAAT -> ACTTTAGTACGCAGCAATC
AAGAGCACCACTTAAGGGT -> AGAGCACCACTTAAGGGTG
AAGAGCACGCCTGGATATT -> AGAGCACGCCTGGATATTT
AAGAGTCATCGTCTGGAGC -> AGAGTCATCGTCTGGAGCT
AAGAGTCGAGCGTTGACAA -> AGAGTCGAGCGTTGACAAG
AAGATCTTCAAAACCTGCG -> AGATCTTCAAAACCTGCGT
AAGCAAAACGTGTTGACTA -> AGCAAAACGTGTTGACTAT
AAGCACCTTGCGCGATTCC -> AGCACCTTGCGCGATTCCT
AAGCCCGAAAGATCTTCAA -> AGCCCGAAAGATCTTCAAA
AAGCTTGCACGGCATGCTC -> AGCTTGCACGGCATGCTCC
AAGGCGCGCAAACATGAGG -> AGGCGCGCAAACATGAGGC
AAGGGCGAAAACCAAATTC -> AGGGCGAAAACCAAATTCG
AAGGGTGGATCAACTAAGT -> AGGGTGGATCAACTAAGTG
AAGTACACGCACAATTGTA -> AGTACACGCACAATTGTAT
AAGTGAGGCAGGATTCTAT -> AGTGAGGCAGGATTCTATC
AAGTGGACACTAGCCGTGG -> AGTGGACACTAGCCGTGGG
AAGTTCCCACACAGCCAAA -> AGTTCCCACACAGCCAAAG
AATACGGTTCCACATAATA -> ATACGGTTCCACATAATAC
AATACTTCACAGTTGCGCC -> ATACTTCACAGTTGCGCCC
AATAGTCAATGCCCCTGGG -> ATAGTCAATGCCCCTGGGT
AATAGTCACCTGTGGCGGT -> ATAGTCACCTGTGGCGGTT
AATAGTCACTTGCACTCCT -> ATAGTCACTTGCACTCCTG
AATAGTCAGGCAGACGTCT -> ATAGTCAGGCAGACGTCTA
AATATCACTTTTGCGGGGT -> ATATCACTTTTGCGGGGTC
AATATTCGGAGAGTGCTTG -> ATATTCGGAGAGTGCTTGA
AATCAATGTGCTATCTTAA -> ATCAATGTGCTATCTTAAC
AATCACACCCTATCCGCTT -> ATCACACCCTATCCGCTTC
AATCAGCACCAGTTACTTA -> ATCAGCACCAGTTACTTAT
AATCAGCTACTATGCCGTT -> ATCAGCTACTATGCCGTTT
AATCAGGGGCACCATCGTG -> ATCAGGGGCACCATCGTGT
AATCGTAAAGCTTGCACGG -> ATCGTAAAGCTTGCACGGC
AATCTAGAGTACGTTCGGC -> ATCTAGAGTACGTTCGGCG
AATCTGTCGGTTAGCCCTT -> ATCTGTCGGTTAGCCCTTC
AATGACACCGATAGTTGAC -> ATGACACCGATAGTTGACG
AATGACATCTCCTGCTATG -> ATGACATCTCCTGCTATGT
AATGATTGGATAAAAACTC -> ATGATTGGATAAAAACTCA
AATGCACCGCTTTGGCTCC -> ATGCACCGCTTTGGCTCCT
AATGCCCCTGGGTGTTGCT -> ATGCCCCTGGGTGTTGCTA
AATGCTAGCCGTCGAGCCC -> ATGCTAGCCGTCGAGCCCT
AATGGAATTCATAGCGTCA -> ATGGAATTCATAGCGTCAA
AATGTGCTATCTTAACCCG -> ATGTGCTATCTTAACCCGT
AATGTGTGTGGCCCTACTC -> ATGTGTGTGGCCCTACTCG
AATTACGCTCGACAAACCG -> ATTACGCTCGACAAACCGA
AATTCATAGCGTCAATTTC -> ATTCATAGCGTCAATTTCG
AATTCGGAACCCCGCGGGG -> ATTCGGAACCCCGCGGGGG
AATTCTTTAGATGTGCCGC -> ATTCTTTAGATGTGCCGCC
AATTGCATTGCCCATGAAT -> ATTGCATTGCCCATGAATA
AATTGCTACCGCGGTCTAA -> ATTGCTACCGCGGTCTAAT
AATTGTACCGGTCCTTCTA -> ATTGTACCGGTCCTTCTAT
AATTGTATCAAAACCGGAG -> ATTGTATCAAAACCGGAGG
AATTTAACCTCCTCAGTTT -> ATTTAACCTCCTCAGTTTT
AATTTATTGATAGACAATT -> ATTTATTGATAGACAATTT
AATTTCGCACAATCAGCTA -> ATTTCGCACAATCAGCTAC
AATTTTCTTAATCAGGGGC -> ATTTTCTTAATCAGGGGCA
ACAAACCGAATGACATCTC -> CAAACCGAATGACATCTCC
ACAACTGGACTTAGGGATG -> CAACTGGACTTAGGGATGA
ACAAGCAAAACGTGTTGAC -> CAAGCAAAACGTGTTGACT
ACAAGTGGACACTAGCCGT -> CAAGTGGACACTAGCCGTG
ACAATCAGCTACTATGCCG -> CAATCAGCTACTATGCCGT
ACAATTCTTTAGATGTGCC -> CAATTCTTTAGATGTGCCG
ACAATTGTATCAAAACCGG -> CAATTGTATCAAAACCGGA
ACAATTTTCTTAATCAGGG -> CAATTTTCTTAATCAGGGG
ACACAACTGGACTTAGGGA -> CACAACTGGACTTAGGGAT
ACACAGCCAAAGCACCTTG -> CACAGCCAAAGCACCTTGC
ACACCCTATCCGCTTCTCT -> CACCCTATCCGCTTCTCTA
ACACCGATAGTTGACGGAG -> CACCGATAGTTGACGGAGA
ACACCTATATCATGAGACG -> CACCTATATCATGAGACGC
ACACGCACAATTGTATCAA -> CACGCACAATTGTATCAAA
ACACGCAGGAGTCCGGGCT -> CACGCAGGAGTCCGGGCTT
ACACTAGCCGTGGGTCGAG -> CACTAGCCGTGGGTCGAGT
ACAGAAAATCTAGAGTACG -> CAGAAAATCTAGAGTACGT
ACAGCCAAAGCACCTTGCG -> CAGCCAAAGCACCTTGCGC
ACAGCGACTACGGCCCAAT -> CAGCGACTACGGCCCAATT
ACAGCGTTCAAAAATACGG -> CAGCGTTCAAAAATACGGT
ACAGTGGTCGACGATTTAA -> CAGTGGTCGACGATTTAAT
ACAGTTGCGCCCTCAAGAG -> CAGTTGCGCCCTCAAGAGC
ACATAATACTTCACAGTTG -> CATAATACTTCACAGTTGC
ACATATAGGTTCTTGCCTG -> CATATAGGTTCTTGCCTGA
ACATATTCGCCACACCTAT -> CATATTCGCCACACCTATA
ACATCTCCATTGCCACCAT -> CATCTCCATTGCCACCATT
ACATCTCCTGCTATGTTCT -> CATCTCCTGCTATGTTCTC
ACATGAGGCGTATGAGTCA -> CATGAGGCGTATGAGTCAG
ACATGGTATAGTACATATA -> CATGGTATAGTACATATAG
ACATGTAACTGCTATTCTA -> CATGTAACTGCTATTCTAT
ACATGTACCAGTCTCGGAT -> CATGTACCAGTCTCGGATT
ACCAAAGTACACGCACAAT -> CCAAAGTACACGCACAATT
ACCAAATTCGGAACCCCGC -> CCAAATTCGGAACCCCGCG
ACCACTTAAGGGTGGATCA -> CCACTTAAGGGTGGATCAA
ACCACTTGACAAGTGGACA -> CCACTTGACAAGTGGACAC
ACCACTTTTGGGGAAATGA -> CCACTTTTGGGGAAATGAC
ACCAGCCATGAACGACACA -> CCAGCCATGAACGACACAA
ACCAGTCTCGGATTACATG -> CCAGTCTCGGATTACATGT
ACCAGTTACTTATGCTGAG -> CCAGTTACTTATGCTGAGC
ACCATCGTGTGGTCATTCA -> CCATCGTGTGGTCATTCAA
ACCATTTTGGCATGGATGA -> CCATTTTGGCATGGATGAT
ACCCACGGACCGCGATGGT -> CCCACGGACCGCGATGGTC
ACCCAGAATTGCATTGCCC -> CCCAGAATTGCATTGCCCA
ACCCCGCGGGGGTCAACGC -> CCCCGCGGGGGTCAACGCA
ACCCGTTCCACGCGGACCT -> CCCGTTCCACGCGGACCTT
ACCCTATCCGCTTCTCTAT -> CCCTATCCGCTTCTCTATT
ACCCTTGCCTGAAACGGGC -> CCCTTGCCTGAAACGGGCA
ACCGAATGACATCTCCTGC -> CCGAATGACATCTCCTGCT
ACCGACTTCTTGGGATACT -> CCGACTTCTTGGGATACTT
ACCGATAGTTGACGGAGAA -> CCGATAGTTGACGGAGAAC
ACCGCAAAACACGCAGGAG -> CCGCAAAACACGCAGGAGT
ACCGCGATGGTCAAATTTA -> CCGCGATGGTCAAATTTAA
ACCGCGGTCTAATTTATTG -> CCGCGGTCTAATTTATTGA
ACCGCTTTGGCTCCTAACT -> CCGCTTTGGCTCCTAACTC
ACCGGAGGCGAAATGGAAT -> CCGGAGGCGAAATGGAATT
ACCGGTCCTTCTATTGGGA -> CCGGTCCTTCTATTGGGAC
ACCGTCAGTTTCCCCACTA -> CCGTCAGTTTCCCCACTAT
ACCTAACGGTTGCTTGTGT -> CCTAACGGTTGCTTGTGTG
ACCTAACTCTACCACTTTT -> CCTAACTCTACCACTTTTG
ACCTATATCATGAGACGCT -> CCTATATCATGAGACGCTG
ACCTATTATAAGGCGCGCA -> CCTATTATAAGGCGCGCAA
ACCTCCTCAGTTTTTTCGG -> CCTCCTCAGTTTTTTCGGC
ACCTGCGTAGAAGTTCCCA -> CCTGCGTAGAAGTTCCCAC
ACCTGTGGCGGTTTGCATA -> CCTGTGGCGGTTTGCATAG
ACCTTGCGCGATTCCTAGT -> CCTTGCGCGATTCCTAGTC
ACCTTGTCCATGTCGCCCC -> CCTTGTCCATGTCGCCCCA
ACGAACCCTTGCCTGAAAC -> CGAACCCTTGCCTGAAACG
ACGACACAACTGGACTTAG -> CGACACAACTGGACTTAGG
ACGACTTCCTTTGGCGCTT -> CGACTTCCTTTGGCGCTTA
ACGAGGAGACCCAGAATTG -> CGAGGAGACCCAGAATTGC
ACGATTTAATCGTAAAGCT -> CGATTTAATCGTAAAGCTT
ACGCACAATTGTATCAAAA -> CGCACAATTGTATCAAAAC
ACGCAGCAATCACACCCTA -> CGCAGCAATCACACCCTAT
ACGCAGGAGTCCGGGCTTG -> CGCAGGAGTCCGGGCTTGA
ACGCATCCTTGACTGTTGG -> CGCATCCTTGACTGTTGGT
ACGCCGATGTCCTGCCTGT -> CGCCGATGTCCTGCCTGTC
ACGCCTGGATATTTAGTGC -> CGCCTGGATATTTAGTGCG
ACGCGAGAGCTTGTCTATC -> CGCGAGAGCTTGTCTATCG
ACGCGGACCTTGTCCATGT -> CGCGGACCTTGTCCATGTC
ACGCTCGACAAACCGAATG -> CGCTCGACAAACCGAATGA
ACGCTGGAGGCATGCGAGC -> CGCTGGAGGCATGCGAGCT
ACGCTGTAAGAGTCGAGCG -> CGCTGTAAGAGTCGAGCGT
ACGGAAGAGTCATCGTCTG -> CGGAAGAGTCATCGTCTGG
ACGGACCGCGATGGTCAAA -> CGGACCGCGATGGTCAAAT
ACGGAGAACAGCGTTCAAA -> CGGAGAACAGCGTTCAAAA
ACGGCATGCTCCCTACATG -> CGGCATGCTCCCTACATGG
ACGGCCCAATTGCTACCGC -> CGGCCCAATTGCTACCGCG
ACGGGCATATATCCGCAGA -> CGGGCATATATCCGCAGAG
ACGGGCATCGGCGAGGTTC -> CGGGCATCGGCGAGGTTCG
ACGGGCATGGGAGAGCGCT -> CGGGCATGGGAGAGCGCTG
ACGGGCATTATGTGTCTAG -> CGGGCATTATGTGTCTAGG
ACGGTTCCACATAATACTT -> CGGTTCCACATAATACTTC
ACGGTTGCTTGTGTGGAAT -> CGGTTGCTTGTGTGGAATG
ACGTATCCCCTTTGACCTA -> CGTATCCCCTTTGACCTAT
ACGTCGTCAACTTGCCTGA -> CGTCGTCAACTTGCCTGAA
ACGTCTAGGTTCCAATCAA -> CGTCTAGGTTCCAATCAAT
ACGTGTTGACTATTGCTTG -> CGTGTTGACTATTGCTTGC
ACGTTACCACTTGACAAGT -> CGTTACCACTTGACAAGTG
ACGTTCGGCGATTGACTTG -> CGTTCGGCGATTGACTTGG
ACTAAACTTTAGTACGCAG -> CTAAACTTTAGTACGCAGC
ACTAACTCTAAATGCTAGC -> CTAACTCTAAATGCTAGCC
ACTAAGTGAGGCAGGATTC -> CTAAGTGAGGCAGGATTCT
ACTACGGCCCAATTGCTAC -> CTACGGCCCAATTGCTACC
ACTAGCCGTGGGTCGAGTA -> CTAGCCGTGGGTCGAGTAT
ACTATAACGTTACCACTTG -> CTATAACGTTACCACTTGA
ACTATGCCGTTTCATCCTG -> CTATGCCGTTTCATCCTGC
ACTATGGCAAGCCCGAAAG -> CTATGGCAAGCCCGAAAGA
ACTATGGCTACTCTTTGTA -> CTATGGCTACTCTTTGTAA
ACTATTGCTTGCCTGAAAC -> CTATTGCTTGCCTGAAACG
ACTCAACTATAACGTTACC -> CTCAACTATAACGTTACCA
ACTCCGGTGTCTCTTCGCC -> CTCCGGTGTCTCTTCGCCG
ACTCCTGGCCTAGTTTGTT -> CTCCTGGCCTAGTTTGTTC
ACTCGAGGGGATGCGACGA -> CTCGAGGGGATGCGACGAG
ACTCTAAATGCTAGCCGTC -> CTCTAAATGCTAGCCGTCG
ACTCTACCACTTTTGGGGA -> CTCTACCACTTTTGGGGAA
ACTCTGACTAACTCTAAAT -> CTCTGACTAACTCTAAATG
ACTCTTTGTAATCAGCACC -> CTCTTTGTAATCAGCACCA
ACTGAATATTCGGAGAGTG -> CTGAATATTCGGAGAGTGC
ACTGCGATCTCTCGAACGC -> CTGCGATCTCTCGAACGCC
ACTGCTATTCTATCACGCT -> CTGCTATTCTATCACGCTG
ACTGGACTTAGGGATGACA -> CTGGACTTAGGGATGACAG
ACTGTTGGTGATAGCGATT -> CTGTTGGTGATAGCGATTC
ACTTAAGGGTGGATCAACT -> CTTAAGGGTGGATCAACTA
ACTTAGGGATGACAGCGAC -> CTTAGGGATGACAGCGACT
ACTTATGCTGAGCTTGTGA -> CTTATGCTGAGCTTGTGAA
ACTTATTTTGTGACAGTGG -> CTTATTTTGTGACAGTGGT
ACTTCACAGTTGCGCCCTC -> CTTCACAGTTGCGCCCTCA
ACTTCCTTTGGCGCTTACC -> CTTCCTTTGGCGCTTACCA
ACTTCTTGGGATACTTATT -> CTTCTTGGGATACTTATTT
ACTTGACAAGTGGACACTA -> CTTGACAAGTGGACACTAG
ACTTGCACTCCTGGCCTAG -> CTTGCACTCCTGGCCTAGT
ACTTGCCTGAAACGGGCAT -> CTTGCCTGAAACGGGCATA
ACTTGGAGTGCAGTCTTAG -> CTTGGAGTGCAGTCTTAGG
ACTTTAGTACGCAGCAATC -> CTTTAGTACGCAGCAATCA
ACTTTTGCGGGGTCGCTCC -> CTTTTGCGGGGTCGCTCCA
ACTTTTGGGGAAATGACAC -> CTTTTGGGGAAATGACACC
ACTTTTGTAACAATTCTTT -> CTTTTGTAACAATTCTTTA
AGAAAATCTAGAGTACGTT -> GAAAATCTAGAGTACGTTC
AGAACAGCGTTCAAAAATA -> GAACAGCGTTCAAAAATAC
AGAAGTTCCCACACAGCCA -> GAAGTTCCCACACAGCCAA
AGAATTGCATTGCCCATGA -> GAATTGCATTGCCCATGAA
AGACAATTTTCTTAATCAG -> GACAATTTTCTTAATCAGG
AGACCCAGAATTGCATTGC -> GACCCAGAATTGCATTGCC
AGACGCTGGAGGCATGCGA -> GACGCTGGAGGCATGCGAG
AGACGTCTAGGTTCCAATC -> GACGTCTAGGTTCCAATCA
AGAGCACCACTTAAGGGTG -> GAGCACCACTTAAGGGTGG
AGAGCACGCCTGGATATTT -> GAGCACGCCTGGATATTTA
AGAGCAGTACGACTTCCTT -> GAGCAGTACGACTTCCTTT
AGAGCGCTGTTTCTCGAAA -> GAGCGCTGTTTCTCGAAAA
AGAGCTTGTCTATCGGCAA -> GAGCTTGTCTATCGGCAAA
AGAGGCTAACCAAAGTACA -> GAGGCTAACCAAAGTACAC
AGAGTACGTTCGGCGATTG -> GAGTACGTTCGGCGATTGA
AGAGTCATCGTCTGGAGCT -> GAGTCATCGTCTGGAGCTA
AGAGTCGAGCGTTGACAAG -> GAGTCGAGCGTTGACAAGC
AGAGTGCTTGACTAAGTCT -> GAGTGCTTGACTAAGTCTC
AGAGTTTCTCGAAAAATAG -> GAGTTTCTCGAAAAATAGT
AGATCTTCAAAACCTGCGT -> GATCTTCAAAACCTGCGTA
AGATGTGCCGCCTGTCCTT -> GATGTGCCGCCTGTCCTTC
AGCAAAACGTGTTGACTAT -> GCAAAACGTGTTGACTATT
AGCAATCACACCCTATCCG -> GCAATCACACCCTATCCGC
AGCACCACTTAAGGGTGGA -> GCACCACTTAAGGGTGGAT
AGCACCAGTTACTTATGCT -> GCACCAGTTACTTATGCTG
AGCACCTTGCGCGATTCCT -> GCACCTTGCGCGATTCCTA
AGCACGCCTGGATATTTAG -> GCACGCCTGGATATTTAGT
AGCAGTACGACTTCCTTTG -> GCAGTACGACTTCCTTTGG
AGCAGTCTGCGGCTACCGA -> GCAGTCTGCGGCTACCGAC
AGCCAAAGCACCTTGCGCG -> GCCAAAGCACCTTGCGCGA
AGCCATGAACGACACAACT -> GCCATGAACGACACAACTG
AGCCCGAAAGATCTTCAAA -> GCCCGAAAGATCTTCAAAA
AGCCCTATCTTATATCGCT -> GCCCTATCTTATATCGCTG
AGCCCTTCGATCAATGCAC -> GCCCTTCGATCAATGCACC
AGCCGTCGAGCCCTATCTT -> GCCGTCGAGCCCTATCTTA
AGCCGTGGGTCGAGTATTC -> GCCGTGGGTCGAGTATTCG
AGCGACTACGGCCCAATTG -> GCGACTACGGCCCAATTGC
AGCGATTCTGTCGGCGGTA -> GCGATTCTGTCGGCGGTAT
AGCGCTGTTTCTCGAAAAA -> GCGCTGTTTCTCGAAAAAT
AGCGTCAATTTCGCACAAT -> GCGTCAATTTCGCACAATC
AGCGTTCAAAAATACGGTT -> GCGTTCAAAAATACGGTTC
AGCGTTGACAAGCAAAACG -> GCGTTGACAAGCAAAACGT
AGCTACTATGCCGTTTCAT -> GCTACTATGCCGTTTCATC
AGCTATATGTCGTGTTCTA -> GCTATATGTCGTGTTCTAG
AGCTCGGGCGAAATCTGTC -> GCTCGGGCGAAATCTGTCG
AGCTTACCGTCAGTTTCCC -> GCTTACCGTCAGTTTCCCC
AGCTTACGTATCCCCTTTG -> GCTTACGTATCCCCTTTGA
AGCTTGCACGGCATGCTCC -> GCTTGCACGGCATGCTCCC
AGCTTGTCTATCGGCAAAT -> GCTTGTCTATCGGCAAATG
AGCTTGTGAATTACGCTCG -> GCTTGTGAATTACGCTCGA
AGGAACGAACCCTTGCCTG -> GGAACGAACCCTTGCCTGA
AGGAGACCCAGAATTGCAT -> GGAGACCCAGAATTGCATT
AGGAGTATACTGAATATTC -> GGAGTATACTGAATATTCG
AGGAGTCCGGGCTTGACTA -> GGAGTCCGGGCTTGACTAT
AGGATTCTATCCTGGCACA -> GGATTCTATCCTGGCACAT
AGGCAGACGTCTAGGTTCC -> GGCAGACGTCTAGGTTCCA
AGGCAGGATTCTATCCTGG -> GGCAGGATTCTATCCTGGC
AGGCATGCGAGCTTACCGT -> GGCATGCGAGCTTACCGTC
AGGCATTTGTTGTATAATT -> GGCATTTGTTGTATAATTG
AGGCGAAATGGAATTCATA -> GGCGAAATGGAATTCATAG
AGGCGCGCAAACATGAGGC -> GGCGCGCAAACATGAGGCG
AGGCGTATGAGTCAGCTCG -> GGCGTATGAGTCAGCTCGG
AGGCTAACCAAAGTACACG -> GGCTAACCAAAGTACACGC
AGGGATGACAGCGACTACG -> GGGATGACAGCGACTACGG
AGGGCGAAAACCAAATTCG -> GGGCGAAAACCAAATTCGG
AGGGGATGCGACGAGGAGA -> GGGGATGCGACGAGGAGAC
AGGGGCACCATCGTGTGGT -> GGGGCACCATCGTGTGGTC
AGGGGGCAGAGGCTAACCA -> GGGGGCAGAGGCTAACCAA
AGGGTGGATCAACTAAGTG -> GGGTGGATCAACTAAGTGA
AGGTTCCAATCAATGTGCT -> GGTTCCAATCAATGTGCTA
AGGTTCGTTTCTCGAAAAA -> GGTTCGTTTCTCGAAAAAT
AGGTTCTTGCCTGAAACGG -> GGTTCTTGCCTGAAACGGG
AGGTTTCTCGAAAAATAGT -> GGTTTCTCGAAAAATAGTC
AGTACACGCACAATTGTAT -> GTACACGCACAATTGTATC
AGTACATATAGGTTCTTGC -> GTACATATAGGTTCTTGCC
AGTACGACTTCCTTTGGCG -> GTACGACTTCCTTTGGCGC
AGTACGCAGCAATCACACC -> GTACGCAGCAATCACACCC
AGTACGTTCGGCGATTGAC -> GTACGTTCGGCGATTGACT
AGTATACTGAATATTCGGA -> GTATACTGAATATTCGGAG
AGTATTCGACTCTGACTAA -> GTATTCGACTCTGACTAAC
AGTCAATGCCCCTGGGTGT -> GTCAATGCCCCTGGGTGTT
AGTCACCTGTGGCGGTTTG -> GTCACCTGTGGCGGTTTGC
AGTCACTTGCACTCCTGGC -> GTCACTTGCACTCCTGGCC
AGTCAGCTCGGGCGAAATC -> GTCAGCTCGGGCGAAATCT
AGTCAGGCAGACGTCTAGG -> GTCAGGCAGACGTCTAGGT
AGTCATCGCTCTGCTGATA -> GTCATCGCTCTGCTGATAG
AGTCATCGTCTGGAGCTAT -> GTCATCGTCTGGAGCTATA
AGTCCGGGCTTGACTATGG -> GTCCGGGCTTGACTATGGC
AGTCGAGCGTTGACAAGCA -> GTCGAGCGTTGACAAGCAA
AGTCGATCGCTGACGTCGT -> GTCGATCGCTGACGTCGTC
AGTCTCGGATTACATGTAA -> GTCTCGGATTACATGTAAC
AGTCTGCGGCTACCGACTT -> GTCTGCGGCTACCGACTTC
AGTCTTAGGAGTATACTGA -> GTCTTAGGAGTATACTGAA
AGTGACCTAACGGTTGCTT -> GTGACCTAACGGTTGCTTG
AGTGAGGCAGGATTCTATC -> GTGAGGCAGGATTCTATCC
AGTGCAGTCTTAGGAGTAT -> GTGCAGTCTTAGGAGTATA
AGTGCGACCCACGGACCGC -> GTGCGACCCACGGACCGCG
AGTGCGCGTGCCCACCGCA -> GTGCGCGTGCCCACCGCAA
AGTGCGGTGATGACCTAAC -> GTGCGGTGATGACCTAACT
AGTGCTTGACTAAGTCTCG -> GTGCTTGACTAAGTCTCGG
AGTGGACACTAGCCGTGGG -> GTGGACACTAGCCGTGGGT
AGTGGACTGCGATCTCTCG -> GTGGACTGCGATCTCTCGA
AGTGGTCGACGATTTAATC -> GTGGTCGACGATTTAATCG
AGTTACTTATGCTGAGCTT -> GTTACTTATGCTGAGCTTG
AGTTCCCACACAGCCAAAG -> GTTCCCACACAGCCAAAGC
AGTTGACGGAGAACAGCGT -> GTTGACGGAGAACAGCGTT
AGTTGCGCCCTCAAGAGCA -> GTTGCGCCCTCAAGAGCAC
AGTTTCCCCACTATGGCAA -> GTTTCCCCACTATGGCAAG
AGTTTCTCGAAAAATAGTC -> GTTTCTCGAAAAATAGTCA
AGTTTGTTCTTGATCTAGT -> GTTTGTTCTTGATCTAGTG
AGTTTTTTCGGCGACTTTT -> GTTTTTTCGGCGACTTTTG
ATAAAAACTCAACTATAAC -> TAAAAACTCAACTATAACG
ATAACGTTACCACTTGACA -> TAACGTTACCACTTGACAA
ATAAGGCGCGCAAACATGA -> TAAGGCGCGCAAACATGAG
ATAATACTTCACAGTTGCG -> TAATACTTCACAGTTGCGC
ATAATTGTACCGGTCCTTC -> TAATTGTACCGGTCCTTCT
ATACATATTCGCCACACCT -> TACATATTCGCCACACCTA
ATACGGTTCCACATAATAC -> TACGGTTCCACATAATACT
ATACTGAATATTCGGAGAG -> TACTGAATATTCGGAGAGT
ATACTTATTTTGTGACAGT -> TACTTATTTTGTGACAGTG
ATACTTCACAGTTGCGCCC -> TACTTCACAGTTGCGCCCT
ATAGACAATTTTCTTAATC -> TAGACAATTTTCTTAATCA
ATAGAGCAGTACGACTTCC -> TAGAGCAGTACGACTTCCT
ATAGCGATTCTGTCGGCGG -> TAGCGATTCTGTCGGCGGT
ATAGCGTCAATTTCGCACA -> TAGCGTCAATTTCGCACAA
ATAGCTTACGTATCCCCTT -> TAGCTTACGTATCCCCTTT
ATAGGTTCTTGCCTGAAAC -> TAGGTTCTTGCCTGAAACG
ATAGTACATATAGGTTCTT -> TAGTACATATAGGTTCTTG
ATAGTCAATGCCCCTGGGT -> TAGTCAATGCCCCTGGGTG
ATAGTCACCTGTGGCGGTT -> TAGTCACCTGTGGCGGTTT
ATAGTCACTTGCACTCCTG -> TAGTCACTTGCACTCCTGG
ATAGTCAGGCAGACGTCTA -> TAGTCAGGCAGACGTCTAG
ATAGTTGACGGAGAACAGC -> TAGTTGACGGAGAACAGCG
ATATACATATTCGCCACAC -> TATACATATTCGCCACACC
ATATAGGTTCTTGCCTGAA -> TATAGGTTCTTGCCTGAAA
ATATATACATATTCGCCAC -> TATATACATATTCGCCACA
ATATATATACATATTCGCC -> TATATATACATATTCGCCA
ATATATCCGCAGAGTTTCT -> TATATCCGCAGAGTTTCTC
ATATCACTTTTGCGGGGTC -> TATCACTTTTGCGGGGTCG
ATATCATGAGACGCTGGAG -> TATCATGAGACGCTGGAGG
ATATCCGCAGAGTTTCTCG -> TATCCGCAGAGTTTCTCGA
ATATCGCTGGGATATATAT -> TATCGCTGGGATATATATA
ATATGTCGTGTTCTAGTGC -> TATGTCGTGTTCTAGTGCG
ATATTCGCCACACCTATAT -> TATTCGCCACACCTATATC
ATATTCGGAGAGTGCTTGA -> TATTCGGAGAGTGCTTGAC
ATATTTAGTGCGCGTGCCC -> TATTTAGTGCGCGTGCCCA
ATCAAAACCGGAGGCGAAA -> TCAAAACCGGAGGCGAAAT
ATCAACTAAGTGAGGCAGG -> TCAACTAAGTGAGGCAGGA
ATCAATGCACCGCTTTGGC -> TCAATGCACCGCTTTGGCT
ATCAATGTGCTATCTTAAC -> TCAATGTGCTATCTTAACC
ATCACACCCTATCCGCTTC -> TCACACCCTATCCGCTTCT
ATCACGCTGTAAGAGTCGA -> TCACGCTGTAAGAGTCGAG
ATCACTTTTGCGGGGTCGC -> TCACTTTTGCGGGGTCGCT
ATCAGCACCAGTTACTTAT -> TCAGCACCAGTTACTTATG
ATCAGCTACTATGCCGTTT -> TCAGCTACTATGCCGTTTC
ATCAGGGGCACCATCGTGT -> TCAGGGGCACCATCGTGTG
ATCAGGGGGCAGAGGCTAA -> TCAGGGGGCAGAGGCTAAC
ATCATGAGACGCTGGAGGC -> TCATGAGACGCTGGAGGCA
ATCCCCTTTGACCTATTAT -> TCCCCTTTGACCTATTATA
ATCCGCAGAGTTTCTCGAA -> TCCGCAGAGTTTCTCGAAA
ATCCGCTTCTCTATTAGTG -> TCCGCTTCTCTATTAGTGC
ATCCTGCTTCCTCCAAACT -> TCCTGCTTCCTCCAAACTA
ATCCTGGCACATCTCCATT -> TCCTGGCACATCTCCATTG
ATCCTTGACTGTTGGTGAT -> TCCTTGACTGTTGGTGATA
ATCGCTCTGCTGATAGCTT -> TCGCTCTGCTGATAGCTTA
ATCGCTGACGTCGTCAACT -> TCGCTGACGTCGTCAACTT
ATCGCTGGGATATATATAC -> TCGCTGGGATATATATACA
ATCGGCAAATGATTGGATA -> TCGGCAAATGATTGGATAA
ATCGGCGAGGTTCGTTTCT -> TCGGCGAGGTTCGTTTCTC
ATCGTAAAGCTTGCACGGC -> TCGTAAAGCTTGCACGGCA
ATCGTCTGGAGCTATATGT -> TCGTCTGGAGCTATATGTC
ATCGTGTGGTCATTCAACG -> TCGTGTGGTCATTCAACGG
ATCTAGAGTACGTTCGGCG -> TCTAGAGTACGTTCGGCGA
ATCTAGTGGACTGCGATCT -> TCTAGTGGACTGCGATCTC
ATCTCCATTGCCACCATTT -> TCTCCATTGCCACCATTTT
ATCTCCTGCTATGTTCTCT -> TCTCCTGCTATGTTCTCTG
ATCTCTCGAACGCCGATGT -> TCTCTCGAACGCCGATGTC
ATCTGGGTAGGAACGAACC -> TCTGGGTAGGAACGAACCC
ATCTGTCGGTTAGCCCTTC -> TCTGTCGGTTAGCCCTTCG
ATCTTAACCCGTTCCACGC -> TCTTAACCCGTTCCACGCG
ATCTTATATCGCTGGGATA -> TCTTATATCGCTGGGATAT
ATCTTCAAAACCTGCGTAG -> TCTTCAAAACCTGCGTAGA
ATGAACGACACAACTGGAC -> TGAACGACACAACTGGACT
ATGAATATCACTTTTGCGG -> TGAATATCACTTTTGCGGG
ATGACACCGATAGTTGACG -> TGACACCGATAGTTGACGG
ATGACAGCGACTACGGCCC -> TGACAGCGACTACGGCCCA
ATGACATCTCCTGCTATGT -> TGACATCTCCTGCTATGTT
ATGACCTAACTCTACCACT -> TGACCTAACTCTACCACTT
ATGAGACGCTGGAGGCATG -> TGAGACGCTGGAGGCATGC
ATGAGGCGTATGAGTCAGC -> TGAGGCGTATGAGTCAGCT
ATGAGTCAGCTCGGGCGAA -> TGAGTCAGCTCGGGCGAAA
ATGATGCAACAGAAAATCT -> TGATGCAACAGAAAATCTA
ATGATTGGATAAAAACTCA -> TGATTGGATAAAAACTCAA
ATGCAACAGAAAATCTAGA -> TGCAACAGAAAATCTAGAG
ATGCACCGCTTTGGCTCCT -> TGCACCGCTTTGGCTCCTA
ATGCCCCTGGGTGTTGCTA -> TGCCCCTGGGTGTTGCTAA
ATGCCGTTTCATCCTGCTT -> TGCCGTTTCATCCTGCTTC
ATGCGACGAGGAGACCCAG -> TGCGACGAGGAGACCCAGA
ATGCGAGCTTACCGTCAGT -> TGCGAGCTTACCGTCAGTT
ATGCTAGCCGTCGAGCCCT -> TGCTAGCCGTCGAGCCCTA
ATGCTCCCTACATGGTATA -> TGCTCCCTACATGGTATAG
ATGCTGAGCTTGTGAATTA -> TGCTGAGCTTGTGAATTAC
ATGGAATTCATAGCGTCAA -> TGGAATTCATAGCGTCAAT
ATGGATGATGCAACAGAAA -> TGGATGATGCAACAGAAAA
ATGGCAAGCCCGAAAGATC -> TGGCAAGCCCGAAAGATCT
ATGGCTACTCTTTGTAATC -> TGGCTACTCTTTGTAATCA
ATGGGAGAGCGCTGTTTCT -> TGGGAGAGCGCTGTTTCTC
ATGGTATAGTACATATAGG -> TGGTATAGTACATATAGGT
ATGGTCAAATTTAACCTCC -> TGGTCAAATTTAACCTCCT
ATGTAACTGCTATTCTATC -> TGTAACTGCTATTCTATCA
ATGTACCAGTCTCGGATTA -> TGTACCAGTCTCGGATTAC
ATGTCCTGCCTGTCTCGTT -> TGTCCTGCCTGTCTCGTTT
ATGTCGCCCCAGTGACCTA -> TGTCGCCCCAGTGACCTAA
ATGTCGTGTTCTAGTGCGG -> TGTCGTGTTCTAGTGCGGT
ATGTGCCGCCTGTCCTTCT -> TGTGCCGCCTGTCCTTCTT
ATGTGCTATCTTAACCCGT -> TGTGCTATCTTAACCCGTT
ATGTGTCTAGGTTTCTCGA -> TGTGTCTAGGTTTCTCGAA
ATGTGTGTGGCCCTACTCG -> TGTGTGTGGCCCTACTCGA
ATGTTCTCTGTGTAGGCAT -> TGTTCTCTGTGTAGGCATT
ATTACATGTAACTGCTATT -> TTACATGTAACTGCTATTC
ATTACGCTCGACAAACCGA -> TTACGCTCGACAAACCGAA
ATTAGTGCGACCCACGGAC -> TTAGTGCGACCCACGGACC
ATTATAAGGCGCGCAAACA -> TTATAAGGCGCGCAAACAT
ATTATGTGTCTAGGTTTCT -> TTATGTGTCTAGGTTTCTC
ATTCAACGGAAGAGTCATC -> TTCAACGGAAGAGTCATCG
ATTCATAGCGTCAATTTCG -> TTCATAGCGTCAATTTCGC
ATTCCTAGTCATCGCTCTG -> TTCCTAGTCATCGCTCTGC
ATTCGACTCTGACTAACTC -> TTCGACTCTGACTAACTCT
ATTCGCCACACCTATATCA -> TTCGCCACACCTATATCAT
ATTCGGAACCCCGCGGGGG -> TTCGGAACCCCGCGGGGGT
ATTCGGAGAGTGCTTGACT -> TTCGGAGAGTGCTTGACTA
ATTCTATCACGCTGTAAGA -> TTCTATCACGCTGTAAGAG
ATTCTATCCTGGCACATCT -> TTCTATCCTGGCACATCTC
ATTCTGTCGGCGGTATCTG -> TTCTGTCGGCGGTATCTGG
ATTCTTTAGATGTGCCGCC -> TTCTTTAGATGTGCCGCCT
ATTGACTTGGAGTGCAGTC -> TTGACTTGGAGTGCAGTCT
ATTGATAGACAATTTTCTT -> TTGATAGACAATTTTCTTA
ATTGCATTGCCCATGAATA -> TTGCATTGCCCATGAATAT
ATTGCCACCATTTTGGCAT -> TTGCCACCATTTTGGCATG
ATTGCCCATGAATATCACT -> TTGCCCATGAATATCACTT
ATTGCTACCGCGGTCTAAT -> TTGCTACCGCGGTCTAATT
ATTGCTTGCCTGAAACGGG -> TTGCTTGCCTGAAACGGGC
ATTGGATAAAAACTCAACT -> TTGGATAAAAACTCAACTA
ATTGGGACATGTACCAGTC -> TTGGGACATGTACCAGTCT
ATTGGTATCAGGGGGCAGA -> TTGGTATCAGGGGGCAGAG
ATTGTACCGGTCCTTCTAT -> TTGTACCGGTCCTTCTATT
ATTGTATCAAAACCGGAGG -> TTGTATCAAAACCGGAGGC
ATTTAACCTCCTCAGTTTT -> TTTAACCTCCTCAGTTTTT
ATTTAATCGTAAAGCTTGC -> TTTAATCGTAAAGCTTGCA
ATTTAGTGCGCGTGCCCAC -> TTTAGTGCGCGTGCCCACC
ATTTATTGATAGACAATTT -> TTTATTGATAGACAATTTT
ATTTCGCACAATCAGCTAC -> TTTCGCACAATCAGCTACT
ATTTGTTGTATAATTGTAC -> TTTGTTGTATAATTGTACC
ATTTTCTTAATCAGGGGCA -> TTTTCTTAATCAGGGGCAC
ATTTTGGCATGGATGATGC -> TTTTGGCATGGATGATGCA
ATTTTGTGACAGTGGTCGA -> TTTTGTGACAGTGGTCGAC
CAAAAATACGGTTCCACAT -> AAAAATACGGTTCCACATA
CAAAACACGCAGGAGTCCG -> AAAACACGCAGGAGTCCGG
CAAAACCGGAGGCGAAATG -> AAAACCGGAGGCGAAATGG
CAAAACCTGCGTAGAAGTT -> AAAACCTGCGTAGAAGTTC
CAAAACGTGTTGACTATTG -> AAAACGTGTTGACTATTGC
CAAACATGAGGCGTATGAG -> AAACATGAGGCGTATGAGT
CAAACCGAATGACATCTCC -> AAACCGAATGACATCTCCT
CAAACTAAACTTTAGTACG -> AAACTAAACTTTAGTACGC
CAAAGCACCTTGCGCGATT -> AAAGCACCTTGCGCGATTC
CAAAGTACACGCACAATTG -> AAAGTACACGCACAATTGT
CAAATGATTGGATAAAAAC -> AAATGATTGGATAAAAACT
CAAATTCGGAACCCCGCGG -> AAATTCGGAACCCCGCGGG
CAAATTTAACCTCCTCAGT -> AAATTTAACCTCCTCAGTT
CAACAGAAAATCTAGAGTA -> AACAGAAAATCTAGAGTAC
CAACGCATCCTTGACTGTT -> AACGCATCCTTGACTGTTG
CAACGGAAGAGTCATCGTC -> AACGGAAGAGTCATCGTCT
CAACTAAGTGAGGCAGGAT -> AACTAAGTGAGGCAGGATT
CAACTATAACGTTACCACT -> AACTATAACGTTACCACTT
CAACTGGACTTAGGGATGA -> AACTGGACTTAGGGATGAC
CAACTTGCCTGAAACGGGC -> AACTTGCCTGAAACGGGCA
CAAGAGCACCACTTAAGGG -> AAGAGCACCACTTAAGGGT
CAAGCAAAACGTGTTGACT -> AAGCAAAACGTGTTGACTA
CAAGCCCGAAAGATCTTCA -> AAGCCCGAAAGATCTTCAA
CAAGTGGACACTAGCCGTG -> AAGTGGACACTAGCCGTGG
CAATCAATGTGCTATCTTA -> AATCAATGTGCTATCTTAA
CAATCACACCCTATCCGCT -> AATCACACCCTATCCGCTT
CAATCAGCTACTATGCCGT -> AATCAGCTACTATGCCGTT
CAATGCACCGCTTTGGCTC -> AATGCACCGCTTTGGCTCC
CAATGCCCCTGGGTGTTGC -> AATGCCCCTGGGTGTTGCT
CAATGTGCTATCTTAACCC -> AATGTGCTATCTTAACCCG
CAATTCTTTAGATGTGCCG -> AATTCTTTAGATGTGCCGC
CAATTGCTACCGCGGTCTA -> AATTGCTACCGCGGTCTAA
CAATTGTATCAAAACCGGA -> AATTGTATCAAAACCGGAG
CAATTTCGCACAATCAGCT -> AATTTCGCACAATCAGCTA
CAATTTTCTTAATCAGGGG -> AATTTTCTTAATCAGGGGC
CACAACTGGACTTAGGGAT -> ACAACTGGACTTAGGGATG
CACAATCAGCTACTATGCC -> ACAATCAGCTACTATGCCG
CACAATTGTATCAAAACCG -> ACAATTGTATCAAAACCGG
CACACAGCCAAAGCACCTT -> ACACAGCCAAAGCACCTTG
CACACCCTATCCGCTTCTC -> ACACCCTATCCGCTTCTCT
CACACCTATATCATGAGAC -> ACACCTATATCATGAGACG
CACAGCCAAAGCACCTTGC -> ACAGCCAAAGCACCTTGCG
CACAGTTGCGCCCTCAAGA -> ACAGTTGCGCCCTCAAGAG
CACATAATACTTCACAGTT -> ACATAATACTTCACAGTTG
CACATCTCCATTGCCACCA -> ACATCTCCATTGCCACCAT
CACCACTTAAGGGTGGATC -> ACCACTTAAGGGTGGATCA
CACCAGTTACTTATGCTGA -> ACCAGTTACTTATGCTGAG
CACCATCGTGTGGTCATTC -> ACCATCGTGTGGTCATTCA
CACCATTTTGGCATGGATG -> ACCATTTTGGCATGGATGA
CACCCTATCCGCTTCTCTA -> ACCCTATCCGCTTCTCTAT
CACCGATAGTTGACGGAGA -> ACCGATAGTTGACGGAGAA
CACCGCAAAACACGCAGGA -> ACCGCAAAACACGCAGGAG
CACCGCTTTGGCTCCTAAC -> ACCGCTTTGGCTCCTAACT
CACCTATATCATGAGACGC -> ACCTATATCATGAGACGCT
CACCTGTGGCGGTTTGCAT -> ACCTGTGGCGGTTTGCATA
CACCTTGCGCGATTCCTAG -> ACCTTGCGCGATTCCTAGT
CACGCACAATTGTATCAAA -> ACGCACAATTGTATCAAAA
CACGCAGGAGTCCGGGCTT -> ACGCAGGAGTCCGGGCTTG
CACGCCTGGATATTTAGTG -> ACGCCTGGATATTTAGTGC
CACGCGAGAGCTTGTCTAT -> ACGCGAGAGCTTGTCTATC
CACGCGGACCTTGTCCATG -> ACGCGGACCTTGTCCATGT
CACGCTGTAAGAGTCGAGC -> ACGCTGTAAGAGTCGAGCG
CACGGACCGCGATGGTCAA -> ACGGACCGCGATGGTCAAA
CACGGCATGCTCCCTACAT -> ACGGCATGCTCCCTACATG
CACTAGCCGTGGGTCGAGT -> ACTAGCCGTGGGTCGAGTA
CACTATGGCAAGCCCGAAA -> ACTATGGCAAGCCCGAAAG
CACTCCTGGCCTAGTTTGT -> ACTCCTGGCCTAGTTTGTT
CACTTAAGGGTGGATCAAC -> ACTTAAGGGTGGATCAACT
CACTTGACAAGTGGACACT -> ACTTGACAAGTGGACACTA
CACTTGCACTCCTGGCCTA -> ACTTGCACTCCTGGCCTAG
CACTTTTGCGGGGTCGCTC -> ACTTTTGCGGGGTCGCTCC
CACTTTTGGGGAAATGACA -> ACTTTTGGGGAAATGACAC
CAGAAAATCTAGAGTACGT -> AGAAAATCTAGAGTACGTT
CAGAATTGCATTGCCCATG -> AGAATTGCATTGCCCATGA
CAGACGTCTAGGTTCCAAT -> AGACGTCTAGGTTCCAATC
CAGAGGCTAACCAAAGTAC -> AGAGGCTAACCAAAGTACA
CAGAGTTTCTCGAAAAATA -> AGAGTTTCTCGAAAAATAG
CAGCAATCACACCCTATCC -> AGCAATCACACCCTATCCG
CAGCACCAGTTACTTATGC -> AGCACCAGTTACTTATGCT
CAGCAGTCTGCGGCTACCG -> AGCAGTCTGCGGCTACCGA
CAGCCAAAGCACCTTGCGC -> AGCCAAAGCACCTTGCGCG
CAGCCATGAACGACACAAC -> AGCCATGAACGACACAACT
CAGCGACTACGGCCCAATT -> AGCGACTACGGCCCAATTG
CAGCGTTCAAAAATACGGT -> AGCGTTCAAAAATACGGTT
CAGCTACTATGCCGTTTCA -> AGCTACTATGCCGTTTCAT
CAGCTCGGGCGAAATCTGT -> AGCTCGGGCGAAATCTGTC
CAGGAGTCCGGGCTTGACT -> AGGAGTCCGGGCTTGACTA
CAGGATTCTATCCTGGCAC -> AGGATTCTATCCTGGCACA
CAGGCAGACGTCTAGGTTC -> AGGCAGACGTCTAGGTTCC
CAGGGGCACCATCGTGTGG -> AGGGGCACCATCGTGTGGT
CAGGGGGCAGAGGCTAACC -> AGGGGGCAGAGGCTAACCA
CAGTACGACTTCCTTTGGC -> AGTACGACTTCCTTTGGCG
CAGTCTCGGATTACATGTA -> AGTCTCGGATTACATGTAA
CAGTCTGCGGCTACCGACT -> AGTCTGCGGCTACCGACTT
CAGTCTTAGGAGTATACTG -> AGTCTTAGGAGTATACTGA
CAGTGACCTAACGGTTGCT -> AGTGACCTAACGGTTGCTT
CAGTGGTCGACGATTTAAT -> AGTGGTCGACGATTTAATC
CAGTTACTTATGCTGAGCT -> AGTTACTTATGCTGAGCTT
CAGTTGCGCCCTCAAGAGC -> AGTTGCGCCCTCAAGAGCA
CAGTTTCCCCACTATGGCA -> AGTTTCCCCACTATGGCAA
CAGTTTTTTCGGCGACTTT -> AGTTTTTTCGGCGACTTTT
CATAATACTTCACAGTTGC -> ATAATACTTCACAGTTGCG
CATAGAGCAGTACGACTTC -> ATAGAGCAGTACGACTTCC
CATAGCGTCAATTTCGCAC -> ATAGCGTCAATTTCGCACA
CATATAGGTTCTTGCCTGA -> ATATAGGTTCTTGCCTGAA
CATATATCCGCAGAGTTTC -> ATATATCCGCAGAGTTTCT
CATATTCGCCACACCTATA -> ATATTCGCCACACCTATAT
CATCCTGCTTCCTCCAAAC -> ATCCTGCTTCCTCCAAACT
CATCCTTGACTGTTGGTGA -> ATCCTTGACTGTTGGTGAT
CATCGCTCTGCTGATAGCT -> ATCGCTCTGCTGATAGCTT
CATCGGCGAGGTTCGTTTC -> ATCGGCGAGGTTCGTTTCT
CATCGTCTGGAGCTATATG -> ATCGTCTGGAGCTATATGT
CATCGTGTGGTCATTCAAC -> ATCGTGTGGTCATTCAACG
CATCTCCATTGCCACCATT -> ATCTCCATTGCCACCATTT
CATCTCCTGCTATGTTCTC -> ATCTCCTGCTATGTTCTCT
CATGAACGACACAACTGGA -> ATGAACGACACAACTGGAC
CATGAATATCACTTTTGCG -> ATGAATATCACTTTTGCGG
CATGAGACGCTGGAGGCAT -> ATGAGACGCTGGAGGCATG
CATGAGGCGTATGAGTCAG -> ATGAGGCGTATGAGTCAGC
CATGCGAGCTTACCGTCAG -> ATGCGAGCTTACCGTCAGT
CATGCTCCCTACATGGTAT -> ATGCTCCCTACATGGTATA
CATGGATGATGCAACAGAA -> ATGGATGATGCAACAGAAA
CATGGGAGAGCGCTGTTTC -> ATGGGAGAGCGCTGTTTCT
CATGGTATAGTACATATAG -> ATGGTATAGTACATATAGG
CATGTAACTGCTATTCTAT -> ATGTAACTGCTATTCTATC
CATGTACCAGTCTCGGATT -> ATGTACCAGTCTCGGATTA
CATGTCGCCCCAGTGACCT -> ATGTCGCCCCAGTGACCTA
CATTATGTGTCTAGGTTTC -> ATTATGTGTCTAGGTTTCT
CATTCAACGGAAGAGTCAT -> ATTCAACGGAAGAGTCATC
CATTGCCACCATTTTGGCA -> ATTGCCACCATTTTGGCAT
CATTGCCCATGAATATCAC -> ATTGCCCATGAATATCACT
CATTGGTATCAGGGGGCAG -> ATTGGTATCAGGGGGCAGA
CATTTGTTGTATAATTGTA -> ATTTGTTGTATAATTGTAC
CATTTTGGCATGGATGATG -> ATTTTGGCATGGATGATGC
CCAAACTAAACTTTAGTAC -> CAAACTAAACTTTAGTACG
CCAAAGCACCTTGCGCGAT -> CAAAGCACCTTGCGCGATT
CCAAAGTACACGCACAATT -> CAAAGTACACGCACAATTG
CCAAATTCGGAACCCCGCG -> CAAATTCGGAACCCCGCGG
CCAATCAATGTGCTATCTT -> CAATCAATGTGCTATCTTA
CCAATTGCTACCGCGGTCT -> CAATTGCTACCGCGGTCTA
CCACACAGCCAAAGCACCT -> CACACAGCCAAAGCACCTT
CCACACCTATATCATGAGA -> CACACCTATATCATGAGAC
CCACATAATACTTCACAGT -> CACATAATACTTCACAGTT
CCACCATTTTGGCATGGAT -> CACCATTTTGGCATGGATG
CCACCGCAAAACACGCAGG -> CACCGCAAAACACGCAGGA
CCACGCGAGAGCTTGTCTA -> CACGCGAGAGCTTGTCTAT
CCACGCGGACCTTGTCCAT -> CACGCGGACCTTGTCCATG
CCACGGACCGCGATGGTCA -> CACGGACCGCGATGGTCAA
CCACTATGGCAAGCCCGAA -> CACTATGGCAAGCCCGAAA
CCACTTAAGGGTGGATCAA -> CACTTAAGGGTGGATCAAC
CCACTTGACAAGTGGACAC -> CACTTGACAAGTGGACACT
CCACTTTTGGGGAAATGAC -> CACTTTTGGGGAAATGACA
CCAGAATTGCATTGCCCAT -> CAGAATTGCATTGCCCATG
CCAGCCATGAACGACACAA -> CAGCCATGAACGACACAAC
CCAGTCTCGGATTACATGT -> CAGTCTCGGATTACATGTA
CCAGTGACCTAACGGTTGC -> CAGTGACCTAACGGTTGCT
CCAGTTACTTATGCTGAGC -> CAGTTACTTATGCTGAGCT
CCATCGTGTGGTCATTCAA -> CATCGTGTGGTCATTCAAC
CCATGAACGACACAACTGG -> CATGAACGACACAACTGGA
CCATGAATATCACTTTTGC -> CATGAATATCACTTTTGCG
CCATGTCGCCCCAGTGACC -> CATGTCGCCCCAGTGACCT
CCATTGCCACCATTTTGGC -> CATTGCCACCATTTTGGCA
CCATTTTGGCATGGATGAT -> CATTTTGGCATGGATGATG
CCCAATTGCTACCGCGGTC -> CCAATTGCTACCGCGGTCT
CCCACACAGCCAAAGCACC -> CCACACAGCCAAAGCACCT
CCCACCGCAAAACACGCAG -> CCACCGCAAAACACGCAGG
CCCACGGACCGCGATGGTC -> CCACGGACCGCGATGGTCA
CCCACTATGGCAAGCCCGA -> CCACTATGGCAAGCCCGAA
CCCAGAATTGCATTGCCCA -> CCAGAATTGCATTGCCCAT
CCCAGTGACCTAACGGTTG -> CCAGTGACCTAACGGTTGC
CCCATGAATATCACTTTTG -> CCATGAATATCACTTTTGC
CCCCACTATGGCAAGCCCG -> CCCACTATGGCAAGCCCGA
CCCCAGTGACCTAACGGTT -> CCCAGTGACCTAACGGTTG
CCCCGCGGGGGTCAACGCA -> CCCGCGGGGGTCAACGCAT
CCCCTGGGTGTTGCTAAAG -> CCCTGGGTGTTGCTAAAGG
CCCCTTTGACCTATTATAA -> CCCTTTGACCTATTATAAG
CCCGAAAGATCTTCAAAAC -> CCGAAAGATCTTCAAAACC
CCCGCGGGGGTCAACGCAT -> CCGCGGGGGTCAACGCATC
CCCGTTCCACGCGGACCTT -> CCGTTCCACGCGGACCTTG
CCCTACATGGTATAGTACA -> CCTACATGGTATAGTACAT
CCCTACTCGAGGGGATGCG -> CCTACTCGAGGGGATGCGA
CCCTATCCGCTTCTCTATT -> CCTATCCGCTTCTCTATTA
CCCTATCTTATATCGCTGG -> CCTATCTTATATCGCTGGG
CCCTCAAGAGCACCACTTA -> CCTCAAGAGCACCACTTAA
CCCTGGGTGTTGCTAAAGG -> CCTGGGTGTTGCTAAAGGG
CCCTTCGATCAATGCACCG -> CCTTCGATCAATGCACCGC
CCCTTGCCTGAAACGGGCA -> CCTTGCCTGAAACGGGCAT
CCCTTTGACCTATTATAAG -> CCTTTGACCTATTATAAGG
CCGAAAGATCTTCAAAACC -> CGAAAGATCTTCAAAACCT
CCGAATGACATCTCCTGCT -> CGAATGACATCTCCTGCTA
CCGACTTCTTGGGATACTT -> CGACTTCTTGGGATACTTA
CCGATAGTTGACGGAGAAC -> CGATAGTTGACGGAGAACA
CCGATGTCCTGCCTGTCTC -> CGATGTCCTGCCTGTCTCG
CCGCAAAACACGCAGGAGT -> CGCAAAACACGCAGGAGTC
CCGCAGAGTTTCTCGAAAA -> CGCAGAGTTTCTCGAAAAA
CCGCCTGTCCTTCTTAAGA -> CGCCTGTCCTTCTTAAGAG
CCGCGATGGTCAAATTTAA -> CGCGATGGTCAAATTTAAC
CCGCGGGGGTCAACGCATC -> CGCGGGGGTCAACGCATCC
CCGCGGTCTAATTTATTGA -> CGCGGTCTAATTTATTGAT
CCGCTTCTCTATTAGTGCG -> CGCTTCTCTATTAGTGCGA
CCGCTTTGGCTCCTAACTC -> CGCTTTGGCTCCTAACTCC
CCGGAGGCGAAATGGAATT -> CGGAGGCGAAATGGAATTC
CCGGGCTTGACTATGGCTA -> CGGGCTTGACTATGGCTAC
CCGGTCCTTCTATTGGGAC -> CGGTCCTTCTATTGGGACA
CCGGTGTCTCTTCGCCGTA -> CGGTGTCTCTTCGCCGTAG
CCGTAGTCGATCGCTGACG -> CGTAGTCGATCGCTGACGT
CCGTCAGTTTCCCCACTAT -> CGTCAGTTTCCCCACTATG
CCGTCGAGCCCTATCTTAT -> CGTCGAGCCCTATCTTATA
CCGTGGGTCGAGTATTCGA -> CGTGGGTCGAGTATTCGAC
CCGTTCCACGCGGACCTTG -> CGTTCCACGCGGACCTTGT
CCGTTTCATCCTGCTTCCT -> CGTTTCATCCTGCTTCCTC
CCTAACGGTTGCTTGTGTG -> CTAACGGTTGCTTGTGTGG
CCTAACTCCGGTGTCTCTT -> CTAACTCCGGTGTCTCTTC
CCTAACTCTACCACTTTTG -> CTAACTCTACCACTTTTGG
CCTACATGGTATAGTACAT -> CTACATGGTATAGTACATA
CCTACTCGAGGGGATGCGA -> CTACTCGAGGGGATGCGAC
CCTAGTCATCGCTCTGCTG -> CTAGTCATCGCTCTGCTGA
CCTAGTTTGTTCTTGATCT -> CTAGTTTGTTCTTGATCTA
CCTATATCATGAGACGCTG -> CTATATCATGAGACGCTGG
CCTATCCGCTTCTCTATTA -> CTATCCGCTTCTCTATTAG
CCTATCTTATATCGCTGGG -> CTATCTTATATCGCTGGGA
CCTATTATAAGGCGCGCAA -> CTATTATAAGGCGCGCAAA
CCTCAAGAGCACCACTTAA -> CTCAAGAGCACCACTTAAG
CCTCAGTTTTTTCGGCGAC -> CTCAGTTTTTTCGGCGACT
CCTCCAAACTAAACTTTAG -> CTCCAAACTAAACTTTAGT
CCTCCTCAGTTTTTTCGGC -> CTCCTCAGTTTTTTCGGCG
CCTGAAACGGGCATATATC -> CTGAAACGGGCATATATCC
CCTGAAACGGGCATCGGCG -> CTGAAACGGGCATCGGCGA
CCTGAAACGGGCATGGGAG -> CTGAAACGGGCATGGGAGA
CCTGAAACGGGCATTATGT -> CTGAAACGGGCATTATGTG
CCTGCCTGTCTCGTTTCAG -> CTGCCTGTCTCGTTTCAGC
CCTGCGTAGAAGTTCCCAC -> CTGCGTAGAAGTTCCCACA
CCTGCTATGTTCTCTGTGT -> CTGCTATGTTCTCTGTGTA
CCTGCTTCCTCCAAACTAA -> CTGCTTCCTCCAAACTAAA
CCTGGATATTTAGTGCGCG -> CTGGATATTTAGTGCGCGT
CCTGGCACATCTCCATTGC -> CTGGCACATCTCCATTGCC
CCTGGCCTAGTTTGTTCTT -> CTGGCCTAGTTTGTTCTTG
CCTGGGTGTTGCTAAAGGG -> CTGGGTGTTGCTAAAGGGC
CCTGTCCTTCTTAAGAGCA -> CTGTCCTTCTTAAGAGCAC
CCTGTCTCGTTTCAGCAGT -> CTGTCTCGTTTCAGCAGTC
CCTGTGGCGGTTTGCATAG -> CTGTGGCGGTTTGCATAGA
CCTTCGATCAATGCACCGC -> CTTCGATCAATGCACCGCT
CCTTCTATTGGGACATGTA -> CTTCTATTGGGACATGTAC
CCTTCTTAAGAGCACGCCT -> CTTCTTAAGAGCACGCCTG
CCTTGACTGTTGGTGATAG -> CTTGACTGTTGGTGATAGC
CCTTGCCTGAAACGGGCAT -> CTTGCCTGAAACGGGCATC
CCTTGCGCGATTCCTAGTC -> CTTGCGCGATTCCTAGTCA
CCTTGTCCATGTCGCCCCA -> CTTGTCCATGTCGCCCCAG
CCTTTGACCTATTATAAGG -> CTTTGACCTATTATAAGGC
CCTTTGGCGCTTACCAGCC -> CTTTGGCGCTTACCAGCCA
CGAAAAATAGTCAATGCCC -> GAAAAATAGTCAATGCCCC
CGAAAAATAGTCACCTGTG -> GAAAAATAGTCACCTGTGG
CGAAAAATAGTCACTTGCA -> GAAAAATAGTCACTTGCAC
CGAAAAATAGTCAGGCAGA -> GAAAAATAGTCAGGCAGAC
CGAAAACCAAATTCGGAAC -> GAAAACCAAATTCGGAACC
CGAAAGATCTTCAAAACCT -> GAAAGATCTTCAAAACCTG
CGAAATCTGTCGGTTAGCC -> GAAATCTGTCGGTTAGCCC
CGAAATGGAATTCATAGCG -> GAAATGGAATTCATAGCGT
CGAACCCTTGCCTGAAACG -> GAACCCTTGCCTGAAACGG
CGAACGCCGATGTCCTGCC -> GAACGCCGATGTCCTGCCT
CGAATGACATCTCCTGCTA -> GAATGACATCTCCTGCTAT
CGACAAACCGAATGACATC -> GACAAACCGAATGACATCT
CGACACAACTGGACTTAGG -> GACACAACTGGACTTAGGG
CGACCCACGGACCGCGATG -> GACCCACGGACCGCGATGG
CGACGAGGAGACCCAGAAT -> GACGAGGAGACCCAGAATT
CGACGATTTAATCGTAAAG -> GACGATTTAATCGTAAAGC
CGACTACGGCCCAATTGCT -> GACTACGGCCCAATTGCTA
CGACTCTGACTAACTCTAA -> GACTCTGACTAACTCTAAA
CGACTTCCTTTGGCGCTTA -> GACTTCCTTTGGCGCTTAC
CGACTTCTTGGGATACTTA -> GACTTCTTGGGATACTTAT
CGACTTTTGTAACAATTCT -> GACTTTTGTAACAATTCTT
CGAGAGCTTGTCTATCGGC -> GAGAGCTTGTCTATCGGCA
CGAGCCCTATCTTATATCG -> GAGCCCTATCTTATATCGC
CGAGCGTTGACAAGCAAAA -> GAGCGTTGACAAGCAAAAC
CGAGCTTACCGTCAGTTTC -> GAGCTTACCGTCAGTTTCC
CGAGGAGACCCAGAATTGC -> GAGGAGACCCAGAATTGCA
CGAGGGGATGCGACGAGGA -> GAGGGGATGCGACGAGGAG
CGAGGTTCGTTTCTCGAAA -> GAGGTTCGTTTCTCGAAAA
CGAGTATTCGACTCTGACT -> GAGTATTCGACTCTGACTA
CGATAGTTGACGGAGAACA -> GATAGTTGACGGAGAACAG
CGATCAATGCACCGCTTTG -> GATCAATGCACCGCTTTGG
CGATCGCTGACGTCGTCAA -> GATCGCTGACGTCGTCAAC
CGATCTCTCGAACGCCGAT -> GATCTCTCGAACGCCGATG
CGATGGTCAAATTTAACCT -> GATGGTCAAATTTAACCTC
CGATGTCCTGCCTGTCTCG -> GATGTCCTGCCTGTCTCGT
CGATTCCTAGTCATCGCTC -> GATTCCTAGTCATCGCTCT
CGATTCTGTCGGCGGTATC -> GATTCTGTCGGCGGTATCT
CGATTGACTTGGAGTGCAG -> GATTGACTTGGAGTGCAGT
CGATTTAATCGTAAAGCTT -> GATTTAATCGTAAAGCTTG
CGCAAAACACGCAGGAGTC -> GCAAAACACGCAGGAGTCC
CGCAAACATGAGGCGTATG -> GCAAACATGAGGCGTATGA
CGCACAATCAGCTACTATG -> GCACAATCAGCTACTATGC
CGCACAATTGTATCAAAAC -> GCACAATTGTATCAAAACC
CGCAGAGTTTCTCGAAAAA -> GCAGAGTTTCTCGAAAAAT
CGCAGCAATCACACCCTAT -> GCAGCAATCACACCCTATC
CGCAGGAGTCCGGGCTTGA -> GCAGGAGTCCGGGCTTGAC
CGCATCCTTGACTGTTGGT -> GCATCCTTGACTGTTGGTG
CGCCACACCTATATCATGA -> GCCACACCTATATCATGAG
CGCCCCAGTGACCTAACGG -> GCCCCAGTGACCTAACGGT
CGCCCTCAAGAGCACCACT -> GCCCTCAAGAGCACCACTT
CGCCGATGTCCTGCCTGTC -> GCCGATGTCCTGCCTGTCT
CGCCGTAGTCGATCGCTGA -> GCCGTAGTCGATCGCTGAC
CGCCTGGATATTTAGTGCG -> GCCTGGATATTTAGTGCGC
CGCCTGTCCTTCTTAAGAG -> GCCTGTCCTTCTTAAGAGC
CGCGAGAGCTTGTCTATCG -> GCGAGAGCTTGTCTATCGG
CGCGATGGTCAAATTTAAC -> GCGATGGTCAAATTTAACC
CGCGATTCCTAGTCATCGC -> GCGATTCCTAGTCATCGCT
CGCGCAAACATGAGGCGTA -> GCGCAAACATGAGGCGTAT
CGCGGACCTTGTCCATGTC -> GCGGACCTTGTCCATGTCG
CGCGGGGGTCAACGCATCC -> GCGGGGGTCAACGCATCCT
CGCGGTCTAATTTATTGAT -> GCGGTCTAATTTATTGATA
CGCGTGCCCACCGCAAAAC -> GCGTGCCCACCGCAAAACA
CGCTCCACGCGAGAGCTTG -> GCTCCACGCGAGAGCTTGT
CGCTCGACAAACCGAATGA -> GCTCGACAAACCGAATGAC
CGCTCTGCTGATAGCTTAC -> GCTCTGCTGATAGCTTACG
CGCTGACGTCGTCAACTTG -> GCTGACGTCGTCAACTTGC
CGCTGGAGGCATGCGAGCT -> GCTGGAGGCATGCGAGCTT
CGCTGGGATATATATACAT -> GCTGGGATATATATACATA
CGCTGTAAGAGTCGAGCGT -> GCTGTAAGAGTCGAGCGTT
CGCTGTTTCTCGAAAAATA -> GCTGTTTCTCGAAAAATAG
CGCTTACCAGCCATGAACG -> GCTTACCAGCCATGAACGA
CGCTTCTCTATTAGTGCGA -> GCTTCTCTATTAGTGCGAC
CGCTTTGGCTCCTAACTCC -> GCTTTGGCTCCTAACTCCG
CGGAACCCCGCGGGGGTCA -> GGAACCCCGCGGGGGTCAA
CGGAAGAGTCATCGTCTGG -> GGAAGAGTCATCGTCTGGA
CGGACCGCGATGGTCAAAT -> GGACCGCGATGGTCAAATT
CGGACCTTGTCCATGTCGC -> GGACCTTGTCCATGTCGCC
CGGAGAACAGCGTTCAAAA -> GGAGAACAGCGTTCAAAAA
CGGAGAGTGCTTGACTAAG -> GGAGAGTGCTTGACTAAGT
CGGAGGCGAAATGGAATTC -> GGAGGCGAAATGGAATTCA
CGGATTACATGTAACTGCT -> GGATTACATGTAACTGCTA
CGGCAAATGATTGGATAAA -> GGCAAATGATTGGATAAAA
CGGCATGCTCCCTACATGG -> GGCATGCTCCCTACATGGT
CGGCCCAATTGCTACCGCG -> GGCCCAATTGCTACCGCGG
CGGCGACTTTTGTAACAAT -> GGCGACTTTTGTAACAATT
CGGCGAGGTTCGTTTCTCG -> GGCGAGGTTCGTTTCTCGA
CGGCGATTGACTTGGAGTG -> GGCGATTGACTTGGAGTGC
CGGCGGTATCTGGGTAGGA -> GGCGGTATCTGGGTAGGAA
CGGCTACCGACTTCTTGGG -> GGCTACCGACTTCTTGGGA
CGGGCATATATCCGCAGAG -> GGGCATATATCCGCAGAGT
CGGGCATCGGCGAGGTTCG -> GGGCATCGGCGAGGTTCGT
CGGGCATGGGAGAGCGCTG -> GGGCATGGGAGAGCGCTGT
CGGGCATTATGTGTCTAGG -> GGGCATTATGTGTCTAGGT
CGGGCGAAATCTGTCGGTT -> GGGCGAAATCTGTCGGTTA
CGGGCTTGACTATGGCTAC -> GGGCTTGACTATGGCTACT
CGGGGGTCAACGCATCCTT -> GGGGGTCAACGCATCCTTG
CGGGGTCGCTCCACGCGAG -> GGGGTCGCTCCACGCGAGA
CGGTATCTGGGTAGGAACG -> GGTATCTGGGTAGGAACGA
CGGTCCTTCTATTGGGACA -> GGTCCTTCTATTGGGACAT
CGGTCTAATTTATTGATAG -> GGTCTAATTTATTGATAGA
CGGTGATGACCTAACTCTA -> GGTGATGACCTAACTCTAC
CGGTGTCTCTTCGCCGTAG -> GGTGTCTCTTCGCCGTAGT
CGGTTAGCCCTTCGATCAA -> GGTTAGCCCTTCGATCAAT
CGGTTCCACATAATACTTC -> GGTTCCACATAATACTTCA
CGGTTGCTTGTGTGGAATG -> GGTTGCTTGTGTGGAATGT
CGGTTTGCATAGAGCAGTA -> GGTTTGCATAGAGCAGTAC
CGTAAAGCTTGCACGGCAT -> GTAAAGCTTGCACGGCATG
CGTAGAAGTTCCCACACAG -> GTAGAAGTTCCCACACAGC
CGTAGTCGATCGCTGACGT -> GTAGTCGATCGCTGACGTC
CGTATCCCCTTTGACCTAT -> GTATCCCCTTTGACCTATT
CGTATGAGTCAGCTCGGGC -> GTATGAGTCAGCTCGGGCG
CGTCAACTTGCCTGAAACG -> GTCAACTTGCCTGAAACGG
CGTCAATTTCGCACAATCA -> GTCAATTTCGCACAATCAG
CGTCAGTTTCCCCACTATG -> GTCAGTTTCCCCACTATGG
CGTCGAGCCCTATCTTATA -> GTCGAGCCCTATCTTATAT
CGTCGTCAACTTGCCTGAA -> GTCGTCAACTTGCCTGAAA
CGTCTAGGTTCCAATCAAT -> GTCTAGGTTCCAATCAATG
CGTCTGGAGCTATATGTCG -> GTCTGGAGCTATATGTCGT
CGTGCCCACCGCAAAACAC -> GTGCCCACCGCAAAACACG
CGTGGGTCGAGTATTCGAC -> GTGGGTCGAGTATTCGACT
CGTGTGGTCATTCAACGGA -> GTGTGGTCATTCAACGGAA
CGTGTTCTAGTGCGGTGAT -> GTGTTCTAGTGCGGTGATG
CGTGTTGACTATTGCTTGC -> GTGTTGACTATTGCTTGCC
CGTTACCACTTGACAAGTG -> GTTACCACTTGACAAGTGG
CGTTCAAAAATACGGTTCC -> GTTCAAAAATACGGTTCCA
CGTTCCACGCGGACCTTGT -> GTTCCACGCGGACCTTGTC
CGTTCGGCGATTGACTTGG -> GTTCGGCGATTGACTTGGA
CGTTGACAAGCAAAACGTG -> GTTGACAAGCAAAACGTGT
CGTTTCAGCAGTCTGCGGC -> GTTTCAGCAGTCTGCGGCT
CGTTTCATCCTGCTTCCTC -> GTTTCATCCTGCTTCCTCC
CGTTTCTCGAAAAATAGTC -> GTTTCTCGAAAAATAGTCA
CTAAACTTTAGTACGCAGC -> TAAACTTTAGTACGCAGCA
CTAAAGGGCGAAAACCAAA -> TAAAGGGCGAAAACCAAAT
CTAAATGCTAGCCGTCGAG -> TAAATGCTAGCCGTCGAGC
CTAACCAAAGTACACGCAC -> TAACCAAAGTACACGCACA
CTAACGGTTGCTTGTGTGG -> TAACGGTTGCTTGTGTGGA
CTAACTCCGGTGTCTCTTC -> TAACTCCGGTGTCTCTTCG
CTAACTCTAAATGCTAGCC -> TAACTCTAAATGCTAGCCG
CTAACTCTACCACTTTTGG -> TAACTCTACCACTTTTGGG
CTAAGTGAGGCAGGATTCT -> TAAGTGAGGCAGGATTCTA
CTAATTTATTGATAGACAA -> TAATTTATTGATAGACAAT
CTACATGGTATAGTACATA -> TACATGGTATAGTACATAT
CTACCACTTTTGGGGAAAT -> TACCACTTTTGGGGAAATG
CTACCGACTTCTTGGGATA -> TACCGACTTCTTGGGATAC
CTACCGCGGTCTAATTTAT -> TACCGCGGTCTAATTTATT
CTACGGCCCAATTGCTACC -> TACGGCCCAATTGCTACCG
CTACTATGCCGTTTCATCC -> TACTATGCCGTTTCATCCT
CTACTCGAGGGGATGCGAC -> TACTCGAGGGGATGCGACG
CTACTCTTTGTAATCAGCA -> TACTCTTTGTAATCAGCAC
CTAGAGTACGTTCGGCGAT -> TAGAGTACGTTCGGCGATT
CTAGCCGTCGAGCCCTATC -> TAGCCGTCGAGCCCTATCT
CTAGCCGTGGGTCGAGTAT -> TAGCCGTGGGTCGAGTATT
CTAGGTTCCAATCAATGTG -> TAGGTTCCAATCAATGTGC
CTAGGTTTCTCGAAAAATA -> TAGGTTTCTCGAAAAATAG
CTAGTCATCGCTCTGCTGA -> TAGTCATCGCTCTGCTGAT
CTAGTGCGGTGATGACCTA -> TAGTGCGGTGATGACCTAA
CTAGTGGACTGCGATCTCT -> TAGTGGACTGCGATCTCTC
CTAGTTTGTTCTTGATCTA -> TAGTTTGTTCTTGATCTAG
CTATAACGTTACCACTTGA -> TATAACGTTACCACTTGAC
CTATATCATGAGACGCTGG -> TATATCATGAGACGCTGGA
CTATATGTCGTGTTCTAGT -> TATATGTCGTGTTCTAGTG
CTATCACGCTGTAAGAGTC -> TATCACGCTGTAAGAGTCG
CTATCCGCTTCTCTATTAG -> TATCCGCTTCTCTATTAGT
CTATCCTGGCACATCTCCA -> TATCCTGGCACATCTCCAT
CTATCGGCAAATGATTGGA -> TATCGGCAAATGATTGGAT
CTATCTTAACCCGTTCCAC -> TATCTTAACCCGTTCCACG
CTATCTTATATCGCTGGGA -> TATCTTATATCGCTGGGAT
CTATGCCGTTTCATCCTGC -> TATGCCGTTTCATCCTGCT
CTATGGCAAGCCCGAAAGA -> TATGGCAAGCCCGAAAGAT
CTATGGCTACTCTTTGTAA -> TATGGCTACTCTTTGTAAT
CTATGTTCTCTGTGTAGGC -> TATGTTCTCTGTGTAGGCA
CTATTAGTGCGACCCACGG -> TATTAGTGCGACCCACGGA
CTATTATAAGGCGCGCAAA -> TATTATAAGGCGCGCAAAC
CTATTCTATCACGCTGTAA -> TATTCTATCACGCTGTAAG
CTATTGCTTGCCTGAAACG -> TATTGCTTGCCTGAAACGG
CTATTGGGACATGTACCAG -> TATTGGGACATGTACCAGT
CTCAACTATAACGTTACCA -> TCAACTATAACGTTACCAC
CTCAAGAGCACCACTTAAG -> TCAAGAGCACCACTTAAGG
CTCAGTTTTTTCGGCGACT -> TCAGTTTTTTCGGCGACTT
CTCCAAACTAAACTTTAGT -> TCCAAACTAAACTTTAGTA
CTCCACGCGAGAGCTTGTC -> TCCACGCGAGAGCTTGTCT
CTCCATTGCCACCATTTTG -> TCCATTGCCACCATTTTGG
CTCCCTACATGGTATAGTA -> TCCCTACATGGTATAGTAC
CTCCGGTGTCTCTTCGCCG -> TCCGGTGTCTCTTCGCCGT
CTCCTAACTCCGGTGTCTC -> TCCTAACTCCGGTGTCTCT
CTCCTCAGTTTTTTCGGCG -> TCCTCAGTTTTTTCGGCGA
CTCCTGCTATGTTCTCTGT -> TCCTGCTATGTTCTCTGTG
CTCCTGGCCTAGTTTGTTC -> TCCTGGCCTAGTTTGTTCT
CTCGAAAAATAGTCAATGC -> TCGAAAAATAGTCAATGCC
CTCGAAAAATAGTCACCTG -> TCGAAAAATAGTCACCTGT
CTCGAAAAATAGTCACTTG -> TCGAAAAATAGTCACTTGC
CTCGAAAAATAGTCAGGCA -> TCGAAAAATAGTCAGGCAG
CTCGAACGCCGATGTCCTG -> TCGAACGCCGATGTCCTGC
CTCGACAAACCGAATGACA -> TCGACAAACCGAATGACAT
CTCGAGGGGATGCGACGAG -> TCGAGGGGATGCGACGAGG
CTCGGATTACATGTAACTG -> TCGGATTACATGTAACTGC
CTCGGGCGAAATCTGTCGG -> TCGGGCGAAATCTGTCGGT
CTCGTTTCAGCAGTCTGCG -> TCGTTTCAGCAGTCTGCGG
CTCTAAATGCTAGCCGTCG -> TCTAAATGCTAGCCGTCGA
CTCTACCACTTTTGGGGAA -> TCTACCACTTTTGGGGAAA
CTCTATTAGTGCGACCCAC -> TCTATTAGTGCGACCCACG
CTCTCGAACGCCGATGTCC -> TCTCGAACGCCGATGTCCT
CTCTGACTAACTCTAAATG -> TCTGACTAACTCTAAATGC
CTCTGCTGATAGCTTACGT -> TCTGCTGATAGCTTACGTA
CTCTGTGTAGGCATTTGTT -> TCTGTGTAGGCATTTGTTG
CTCTTCGCCGTAGTCGATC -> TCTTCGCCGTAGTCGATCG
CTCTTTGTAATCAGCACCA -> TCTTTGTAATCAGCACCAG
CTGAAACGGGCATATATCC -> TGAAACGGGCATATATCCG
CTGAAACGGGCATCGGCGA -> TGAAACGGGCATCGGCGAG
CTGAAACGGGCATGGGAGA -> TGAAACGGGCATGGGAGAG
CTGAAACGGGCATTATGTG -> TGAAACGGGCATTATGTGT
CTGAATATTCGGAGAGTGC -> TGAATATTCGGAGAGTGCT
CTGACGTCGTCAACTTGCC -> TGACGTCGTCAACTTGCCT
CTGACTAACTCTAAATGCT -> TGACTAACTCTAAATGCTA
CTGAGCTTGTGAATTACGC -> TGAGCTTGTGAATTACGCT
CTGATAGCTTACGTATCCC -> TGATAGCTTACGTATCCCC
CTGCCTGTCTCGTTTCAGC -> TGCCTGTCTCGTTTCAGCA
CTGCGATCTCTCGAACGCC -> TGCGATCTCTCGAACGCCG
CTGCGGCTACCGACTTCTT -> TGCGGCTACCGACTTCTTG
CTGCGTAGAAGTTCCCACA -> TGCGTAGAAGTTCCCACAC
CTGCTATGTTCTCTGTGTA -> TGCTATGTTCTCTGTGTAG
CTGCTATTCTATCACGCTG -> TGCTATTCTATCACGCTGT
CTGCTGATAGCTTACGTAT -> TGCTGATAGCTTACGTATC
CTGCTTCCTCCAAACTAAA -> TGCTTCCTCCAAACTAAAC
CTGGACTTAGGGATGACAG -> TGGACTTAGGGATGACAGC
CTGGAGCTATATGTCGTGT -> TGGAGCTATATGTCGTGTT
CTGGAGGCATGCGAGCTTA -> TGGAGGCATGCGAGCTTAC
CTGGATATTTAGTGCGCGT -> TGGATATTTAGTGCGCGTG
CTGGCACATCTCCATTGCC -> TGGCACATCTCCATTGCCA
CTGGCCTAGTTTGTTCTTG -> TGGCCTAGTTTGTTCTTGA
CTGGGATATATATACATAT -> TGGGATATATATACATATT
CTGGGTAGGAACGAACCCT -> TGGGTAGGAACGAACCCTT
CTGGGTGTTGCTAAAGGGC -> TGGGTGTTGCTAAAGGGCG
CTGTAAGAGTCGAGCGTTG -> TGTAAGAGTCGAGCGTTGA
CTGTCCTTCTTAAGAGCAC -> TGTCCTTCTTAAGAGCACG
CTGTCGGCGGTATCTGGGT -> TGTCGGCGGTATCTGGGTA
CTGTCGGTTAGCCCTTCGA -> TGTCGGTTAGCCCTTCGAT
CTGTCTCGTTTCAGCAGTC -> TGTCTCGTTTCAGCAGTCT
CTGTGGCGGTTTGCATAGA -> TGTGGCGGTTTGCATAGAG
CTGTGTAGGCATTTGTTGT -> TGTGTAGGCATTTGTTGTA
CTGTTGGTGATAGCGATTC -> TGTTGGTGATAGCGATTCT
CTGTTTCTCGAAAAATAGT -> TGTTTCTCGAAAAATAGTC
CTTAACCCGTTCCACGCGG -> TTAACCCGTTCCACGCGGA
CTTAAGAGCACGCCTGGAT -> TTAAGAGCACGCCTGGATA
CTTAAGGGTGGATCAACTA -> TTAAGGGTGGATCAACTAA
CTTAATCAGGGGCACCATC -> TTAATCAGGGGCACCATCG
CTTACCAGCCATGAACGAC -> TTACCAGCCATGAACGACA
CTTACCGTCAGTTTCCCCA -> TTACCGTCAGTTTCCCCAC
CTTACGTATCCCCTTTGAC -> TTACGTATCCCCTTTGACC
CTTAGGAGTATACTGAATA -> TTAGGAGTATACTGAATAT
CTTAGGGATGACAGCGACT -> TTAGGGATGACAGCGACTA
CTTATATCGCTGGGATATA -> TTATATCGCTGGGATATAT
CTTATGCTGAGCTTGTGAA -> TTATGCTGAGCTTGTGAAT
CTTATTTTGTGACAGTGGT -> TTATTTTGTGACAGTGGTC
CTTCAAAACCTGCGTAGAA -> TTCAAAACCTGCGTAGAAG
CTTCACAGTTGCGCCCTCA -> TTCACAGTTGCGCCCTCAA
CTTCCTCCAAACTAAACTT -> TTCCTCCAAACTAAACTTT
CTTCCTTTGGCGCTTACCA -> TTCCTTTGGCGCTTACCAG
CTTCGATCAATGCACCGCT -> TTCGATCAATGCACCGCTT
CTTCGCCGTAGTCGATCGC -> TTCGCCGTAGTCGATCGCT
CTTCTATTGGGACATGTAC -> TTCTATTGGGACATGTACC
CTTCTCTATTAGTGCGACC -> TTCTCTATTAGTGCGACCC
CTTCTTAAGAGCACGCCTG -> TTCTTAAGAGCACGCCTGG
CTTCTTGGGATACTTATTT -> TTCTTGGGATACTTATTTT
CTTGACAAGTGGACACTAG -> TTGACAAGTGGACACTAGC
CTTGACTATGGCTACTCTT -> TTGACTATGGCTACTCTTT
CTTGACTGTTGGTGATAGC -> TTGACTGTTGGTGATAGCG
CTTGATCTAGTGGACTGCG -> TTGATCTAGTGGACTGCGA
CTTGCACGGCATGCTCCCT -> TTGCACGGCATGCTCCCTA
CTTGCACTCCTGGCCTAGT -> TTGCACTCCTGGCCTAGTT
CTTGCCTGAAACGGGCATA -> TTGCCTGAAACGGGCATAT
CTTGCCTGAAACGGGCATC -> TTGCCTGAAACGGGCATCG
CTTGCCTGAAACGGGCATG -> TTGCCTGAAACGGGCATGG
CTTGCCTGAAACGGGCATT -> TTGCCTGAAACGGGCATTA
CTTGCGCGATTCCTAGTCA -> TTGCGCGATTCCTAGTCAT
CTTGGAGTGCAGTCTTAGG -> TTGGAGTGCAGTCTTAGGA
CTTGGGATACTTATTTTGT -> TTGGGATACTTATTTTGTG
CTTGTCCATGTCGCCCCAG -> TTGTCCATGTCGCCCCAGT
CTTGTCTATCGGCAAATGA -> TTGTCTATCGGCAAATGAT
CTTGTGAATTACGCTCGAC -> TTGTGAATTACGCTCGACA
CTTGTGTGGAATGTGTGTG -> TTGTGTGGAATGTGTGTGG
CTTTAGATGTGCCGCCTGT -> TTTAGATGTGCCGCCTGTC
CTTTAGTACGCAGCAATCA -> TTTAGTACGCAGCAATCAC
CTTTGACCTATTATAAGGC -> TTTGACCTATTATAAGGCG
CTTTGGCGCTTACCAGCCA -> TTTGGCGCTTACCAGCCAT
CTTTGGCTCCTAACTCCGG -> TTTGGCTCCTAACTCCGGT
CTTTGTAATCAGCACCAGT -> TTTGTAATCAGCACCAGTT
CTTTTGCGGGGTCGCTCCA -> TTTTGCGGGGTCGCTCCAC
CTTTTGGGGAAATGACACC -> TTTTGGGGAAATGACACCG
CTTTTGTAACAATTCTTTA -> TTTTGTAACAATTCTTTAG
GAAAAATAGTCAATGCCCC -> AAAAATAGTCAATGCCCCT
GAAAAATAGTCACCTGTGG -> AAAAATAGTCACCTGTGGC
GAAAAATAGTCACTTGCAC -> AAAAATAGTCACTTGCACT
GAAAAATAGTCAGGCAGAC -> AAAAATAGTCAGGCAGACG
GAAAACCAAATTCGGAACC -> AAAACCAAATTCGGAACCC
GAAAATCTAGAGTACGTTC -> AAAATCTAGAGTACGTTCG
GAAACGGGCATATATCCGC -> AAACGGGCATATATCCGCA
GAAACGGGCATCGGCGAGG -> AAACGGGCATCGGCGAGGT
GAAACGGGCATGGGAGAGC -> AAACGGGCATGGGAGAGCG
GAAACGGGCATTATGTGTC -> AAACGGGCATTATGTGTCT
GAAAGATCTTCAAAACCTG -> AAAGATCTTCAAAACCTGC
GAAATCTGTCGGTTAGCCC -> AAATCTGTCGGTTAGCCCT
GAAATGACACCGATAGTTG -> AAATGACACCGATAGTTGA
GAAATGGAATTCATAGCGT -> AAATGGAATTCATAGCGTC
GAACAGCGTTCAAAAATAC -> AACAGCGTTCAAAAATACG
GAACCCCGCGGGGGTCAAC -> AACCCCGCGGGGGTCAACG
GAACCCTTGCCTGAAACGG -> AACCCTTGCCTGAAACGGG
GAACGAACCCTTGCCTGAA -> AACGAACCCTTGCCTGAAA
GAACGACACAACTGGACTT -> AACGACACAACTGGACTTA
GAACGCCGATGTCCTGCCT -> AACGCCGATGTCCTGCCTG
GAAGAGTCATCGTCTGGAG -> AAGAGTCATCGTCTGGAGC
GAAGTTCCCACACAGCCAA -> AAGTTCCCACACAGCCAAA
GAATATCACTTTTGCGGGG -> AATATCACTTTTGCGGGGT
GAATATTCGGAGAGTGCTT -> AATATTCGGAGAGTGCTTG
GAATGACATCTCCTGCTAT -> AATGACATCTCCTGCTATG
GAATGTGTGTGGCCCTACT -> AATGTGTGTGGCCCTACTC
GAATTACGCTCGACAAACC -> AATTACGCTCGACAAACCG
GAATTCATAGCGTCAATTT -> AATTCATAGCGTCAATTTC
GAATTGCATTGCCCATGAA -> AATTGCATTGCCCATGAAT
GACAAACCGAATGACATCT -> ACAAACCGAATGACATCTC
GACAAGCAAAACGTGTTGA -> ACAAGCAAAACGTGTTGAC
GACAAGTGGACACTAGCCG -> ACAAGTGGACACTAGCCGT
GACAATTTTCTTAATCAGG -> ACAATTTTCTTAATCAGGG
GACACAACTGGACTTAGGG -> ACACAACTGGACTTAGGGA
GACACCGATAGTTGACGGA -> ACACCGATAGTTGACGGAG
GACACTAGCCGTGGGTCGA -> ACACTAGCCGTGGGTCGAG
GACAGCGACTACGGCCCAA -> ACAGCGACTACGGCCCAAT
GACAGTGGTCGACGATTTA -> ACAGTGGTCGACGATTTAA
GACATCTCCTGCTATGTTC -> ACATCTCCTGCTATGTTCT
GACATGTACCAGTCTCGGA -> ACATGTACCAGTCTCGGAT
GACCCACGGACCGCGATGG -> ACCCACGGACCGCGATGGT
GACCCAGAATTGCATTGCC -> ACCCAGAATTGCATTGCCC
GACCGCGATGGTCAAATTT -> ACCGCGATGGTCAAATTTA
GACCTAACGGTTGCTTGTG -> ACCTAACGGTTGCTTGTGT
GACCTAACTCTACCACTTT -> ACCTAACTCTACCACTTTT
GACCTATTATAAGGCGCGC -> ACCTATTATAAGGCGCGCA
GACCTTGTCCATGTCGCCC -> ACCTTGTCCATGTCGCCCC
GACGAGGAGACCCAGAATT -> ACGAGGAGACCCAGAATTG
GACGATTTAATCGTAAAGC -> ACGATTTAATCGTAAAGCT
GACGCTGGAGGCATGCGAG -> ACGCTGGAGGCATGCGAGC
GACGGAGAACAGCGTTCAA -> ACGGAGAACAGCGTTCAAA
GACGTCGTCAACTTGCCTG -> ACGTCGTCAACTTGCCTGA
GACGTCTAGGTTCCAATCA -> ACGTCTAGGTTCCAATCAA
GACTAACTCTAAATGCTAG -> ACTAACTCTAAATGCTAGC
GACTACGGCCCAATTGCTA -> ACTACGGCCCAATTGCTAC
GACTATGGCTACTCTTTGT -> ACTATGGCTACTCTTTGTA
GACTATTGCTTGCCTGAAA -> ACTATTGCTTGCCTGAAAC
GACTCTGACTAACTCTAAA -> ACTCTGACTAACTCTAAAT
GACTGCGATCTCTCGAACG -> ACTGCGATCTCTCGAACGC
GACTGTTGGTGATAGCGAT -> ACTGTTGGTGATAGCGATT
GACTTAGGGATGACAGCGA -> ACTTAGGGATGACAGCGAC
GACTTCCTTTGGCGCTTAC -> ACTTCCTTTGGCGCTTACC
GACTTCTTGGGATACTTAT -> ACTTCTTGGGATACTTATT
GACTTGGAGTGCAGTCTTA -> ACTTGGAGTGCAGTCTTAG
GACTTTTGTAACAATTCTT -> ACTTTTGTAACAATTCTTT
GAGAACAGCGTTCAAAAAT -> AGAACAGCGTTCAAAAATA
GAGACCCAGAATTGCATTG -> AGACCCAGAATTGCATTGC
GAGACGCTGGAGGCATGCG -> AGACGCTGGAGGCATGCGA
GAGAGCGCTGTTTCTCGAA -> AGAGCGCTGTTTCTCGAAA
GAGAGCTTGTCTATCGGCA -> AGAGCTTGTCTATCGGCAA
GAGAGTGCTTGACTAAGTC -> AGAGTGCTTGACTAAGTCT
GAGCACCACTTAAGGGTGG -> AGCACCACTTAAGGGTGGA
GAGCACGCCTGGATATTTA -> AGCACGCCTGGATATTTAG
GAGCAGTACGACTTCCTTT -> AGCAGTACGACTTCCTTTG
GAGCCCTATCTTATATCGC -> AGCCCTATCTTATATCGCT
GAGCGCTGTTTCTCGAAAA -> AGCGCTGTTTCTCGAAAAA
GAGCGTTGACAAGCAAAAC -> AGCGTTGACAAGCAAAACG
GAGCTATATGTCGTGTTCT -> AGCTATATGTCGTGTTCTA
GAGCTTACCGTCAGTTTCC -> AGCTTACCGTCAGTTTCCC
GAGCTTGTCTATCGGCAAA -> AGCTTGTCTATCGGCAAAT
GAGCTTGTGAATTACGCTC -> AGCTTGTGAATTACGCTCG
GAGGAGACCCAGAATTGCA -> AGGAGACCCAGAATTGCAT
GAGGCAGGATTCTATCCTG -> AGGCAGGATTCTATCCTGG
GAGGCATGCGAGCTTACCG -> AGGCATGCGAGCTTACCGT
GAGGCGAAATGGAATTCAT -> AGGCGAAATGGAATTCATA
GAGGCGTATGAGTCAGCTC -> AGGCGTATGAGTCAGCTCG
GAGGCTAACCAAAGTACAC -> AGGCTAACCAAAGTACACG
GAGGGGATGCGACGAGGAG -> AGGGGATGCGACGAGGAGA
GAGGTTCGTTTCTCGAAAA -> AGGTTCGTTTCTCGAAAAA
GAGTACGTTCGGCGATTGA -> AGTACGTTCGGCGATTGAC
GAGTATACTGAATATTCGG -> AGTATACTGAATATTCGGA
GAGTATTCGACTCTGACTA -> AGTATTCGACTCTGACTAA
GAGTCAGCTCGGGCGAAAT -> AGTCAGCTCGGGCGAAATC
GAGTCATCGTCTGGAGCTA -> AGTCATCGTCTGGAGCTAT
GAGTCCGGGCTTGACTATG -> AGTCCGGGCTTGACTATGG
GAGTCGAGCGTTGACAAGC -> AGTCGAGCGTTGACAAGCA
GAGTGCAGTCTTAGGAGTA -> AGTGCAGTCTTAGGAGTAT
GAGTGCTTGACTAAGTCTC -> AGTGCTTGACTAAGTCTCG
GAGTTTCTCGAAAAATAGT -> AGTTTCTCGAAAAATAGTC
GATAAAAACTCAACTATAA -> ATAAAAACTCAACTATAAC
GATACTTATTTTGTGACAG -> ATACTTATTTTGTGACAGT
GATAGACAATTTTCTTAAT -> ATAGACAATTTTCTTAATC
GATAGCGATTCTGTCGGCG -> ATAGCGATTCTGTCGGCGG
GATAGCTTACGTATCCCCT -> ATAGCTTACGTATCCCCTT
GATAGTTGACGGAGAACAG -> ATAGTTGACGGAGAACAGC
GATATATATACATATTCGC -> ATATATATACATATTCGCC
GATATTTAGTGCGCGTGCC -> ATATTTAGTGCGCGTGCCC
GATCAACTAAGTGAGGCAG -> ATCAACTAAGTGAGGCAGG
GATCAATGCACCGCTTTGG -> ATCAATGCACCGCTTTGGC
GATCGCTGACGTCGTCAAC -> ATCGCTGACGTCGTCAACT
GATCTAGTGGACTGCGATC -> ATCTAGTGGACTGCGATCT
GATCTCTCGAACGCCGATG -> ATCTCTCGAACGCCGATGT
GATCTTCAAAACCTGCGTA -> ATCTTCAAAACCTGCGTAG
GATGACAGCGACTACGGCC -> ATGACAGCGACTACGGCCC
GATGACCTAACTCTACCAC -> ATGACCTAACTCTACCACT
GATGATGCAACAGAAAATC -> ATGATGCAACAGAAAATCT
GATGCAACAGAAAATCTAG -> ATGCAACAGAAAATCTAGA
GATGCGACGAGGAGACCCA -> ATGCGACGAGGAGACCCAG
GATGGTCAAATTTAACCTC -> ATGGTCAAATTTAACCTCC
GATGTCCTGCCTGTCTCGT -> ATGTCCTGCCTGTCTCGTT
GATGTGCCGCCTGTCCTTC -> ATGTGCCGCCTGTCCTTCT
GATTACATGTAACTGCTAT -> ATTACATGTAACTGCTATT
GATTCCTAGTCATCGCTCT -> ATTCCTAGTCATCGCTCTG
GATTCTATCCTGGCACATC -> ATTCTATCCTGGCACATCT
GATTCTGTCGGCGGTATCT -> ATTCTGTCGGCGGTATCTG
GATTGACTTGGAGTGCAGT -> ATTGACTTGGAGTGCAGTC
GATTGGATAAAAACTCAAC -> ATTGGATAAAAACTCAACT
GATTTAATCGTAAAGCTTG -> ATTTAATCGTAAAGCTTGC
GCAAAACACGCAGGAGTCC -> CAAAACACGCAGGAGTCCG
GCAAAACGTGTTGACTATT -> CAAAACGTGTTGACTATTG
GCAAACATGAGGCGTATGA -> CAAACATGAGGCGTATGAG
GCAAATGATTGGATAAAAA -> CAAATGATTGGATAAAAAC
GCAACAGAAAATCTAGAGT -> CAACAGAAAATCTAGAGTA
GCAAGCCCGAAAGATCTTC -> CAAGCCCGAAAGATCTTCA
GCAATCACACCCTATCCGC -> CAATCACACCCTATCCGCT
GCACAATCAGCTACTATGC -> CACAATCAGCTACTATGCC
GCACAATTGTATCAAAACC -> CACAATTGTATCAAAACCG
GCACATCTCCATTGCCACC -> CACATCTCCATTGCCACCA
GCACCACTTAAGGGTGGAT -> CACCACTTAAGGGTGGATC
GCACCAGTTACTTATGCTG -> CACCAGTTACTTATGCTGA
GCACCATCGTGTGGTCATT -> CACCATCGTGTGGTCATTC
GCACCGCTTTGGCTCCTAA -> CACCGCTTTGGCTCCTAAC
GCACCTTGCGCGATTCCTA -> CACCTTGCGCGATTCCTAG
GCACGCCTGGATATTTAGT -> CACGCCTGGATATTTAGTG
GCACGGCATGCTCCCTACA -> CACGGCATGCTCCCTACAT
GCACTCCTGGCCTAGTTTG -> CACTCCTGGCCTAGTTTGT
GCAGACGTCTAGGTTCCAA -> CAGACGTCTAGGTTCCAAT
GCAGAGGCTAACCAAAGTA -> CAGAGGCTAACCAAAGTAC
GCAGAGTTTCTCGAAAAAT -> CAGAGTTTCTCGAAAAATA
GCAGCAATCACACCCTATC -> CAGCAATCACACCCTATCC
GCAGGAGTCCGGGCTTGAC -> CAGGAGTCCGGGCTTGACT
GCAGGATTCTATCCTGGCA -> CAGGATTCTATCCTGGCAC
GCAGTACGACTTCCTTTGG -> CAGTACGACTTCCTTTGGC
GCAGTCTGCGGCTACCGAC -> CAGTCTGCGGCTACCGACT
GCAGTCTTAGGAGTATACT -> CAGTCTTAGGAGTATACTG
GCATAGAGCAGTACGACTT -> CATAGAGCAGTACGACTTC
GCATATATCCGCAGAGTTT -> CATATATCCGCAGAGTTTC
GCATCCTTGACTGTTGGTG -> CATCCTTGACTGTTGGTGA
GCATCGGCGAGGTTCGTTT -> CATCGGCGAGGTTCGTTTC
GCATGCGAGCTTACCGTCA -> CATGCGAGCTTACCGTCAG
GCATGCTCCCTACATGGTA -> CATGCTCCCTACATGGTAT
GCATGGATGATGCAACAGA -> CATGGATGATGCAACAGAA
GCATGGGAGAGCGCTGTTT -> CATGGGAGAGCGCTGTTTC
GCATTATGTGTCTAGGTTT -> CATTATGTGTCTAGGTTTC
GCATTGCCCATGAATATCA -> CATTGCCCATGAATATCAC
GCATTTGTTGTATAATTGT -> CATTTGTTGTATAATTGTA
GCCAAAGCACCTTGCGCGA -> CCAAAGCACCTTGCGCGAT
GCCACACCTATATCATGAG -> CCACACCTATATCATGAGA
GCCACCATTTTGGCATGGA -> CCACCATTTTGGCATGGAT
GCCATGAACGACACAACTG -> CCATGAACGACACAACTGG
GCCCAATTGCTACCGCGGT -> CCCAATTGCTACCGCGGTC
GCCCACCGCAAAACACGCA -> CCCACCGCAAAACACGCAG
GCCCATGAATATCACTTTT -> CCCATGAATATCACTTTTG
GCCCCAGTGACCTAACGGT -> CCCCAGTGACCTAACGGTT
GCCCCTGGGTGTTGCTAAA -> CCCCTGGGTGTTGCTAAAG
GCCCGAAAGATCTTCAAAA -> CCCGAAAGATCTTCAAAAC
GCCCTACTCGAGGGGATGC -> CCCTACTCGAGGGGATGCG
GCCCTATCTTATATCGCTG -> CCCTATCTTATATCGCTGG
GCCCTCAAGAGCACCACTT -> CCCTCAAGAGCACCACTTA
GCCCTTCGATCAATGCACC -> CCCTTCGATCAATGCACCG
GCCGATGTCCTGCCTGTCT -> CCGATGTCCTGCCTGTCTC
GCCGCCTGTCCTTCTTAAG -> CCGCCTGTCCTTCTTAAGA
GCCGTAGTCGATCGCTGAC -> CCGTAGTCGATCGCTGACG
GCCGTCGAGCCCTATCTTA -> CCGTCGAGCCCTATCTTAT
GCCGTGGGTCGAGTATTCG -> CCGTGGGTCGAGTATTCGA
GCCGTTTCATCCTGCTTCC -> CCGTTTCATCCTGCTTCCT
GCCTAGTTTGTTCTTGATC -> CCTAGTTTGTTCTTGATCT
GCCTGAAACGGGCATATAT -> CCTGAAACGGGCATATATC
GCCTGAAACGGGCATCGGC -> CCTGAAACGGGCATCGGCG
GCCTGAAACGGGCATGGGA -> CCTGAAACGGGCATGGGAG
GCCTGAAACGGGCATTATG -> CCTGAAACGGGCATTATGT
GCCTGGATATTTAGTGCGC -> CCTGGATATTTAGTGCGCG
GCCTGTCCTTCTTAAGAGC -> CCTGTCCTTCTTAAGAGCA
GCCTGTCTCGTTTCAGCAG -> CCTGTCTCGTTTCAGCAGT
GCGAAAACCAAATTCGGAA -> CGAAAACCAAATTCGGAAC
GCGAAATCTGTCGGTTAGC -> CGAAATCTGTCGGTTAGCC
GCGAAATGGAATTCATAGC -> CGAAATGGAATTCATAGCG
GCGACCCACGGACCGCGAT -> CGACCCACGGACCGCGATG
GCGACGAGGAGACCCAGAA -> CGACGAGGAGACCCAGAAT
GCGACTACGGCCCAATTGC -> CGACTACGGCCCAATTGCT
GCGACTTTTGTAACAATTC -> CGACTTTTGTAACAATTCT
GCGAGAGCTTGTCTATCGG -> CGAGAGCTTGTCTATCGGC
GCGAGCTTACCGTCAGTTT -> CGAGCTTACCGTCAGTTTC
GCGAGGTTCGTTTCTCGAA -> CGAGGTTCGTTTCTCGAAA
GCGATCTCTCGAACGCCGA -> CGATCTCTCGAACGCCGAT
GCGATGGTCAAATTTAACC -> CGATGGTCAAATTTAACCT
GCGATTCCTAGTCATCGCT -> CGATTCCTAGTCATCGCTC
GCGATTCTGTCGGCGGTAT -> CGATTCTGTCGGCGGTATC
GCGATTGACTTGGAGTGCA -> CGATTGACTTGGAGTGCAG
GCGCAAACATGAGGCGTAT -> CGCAAACATGAGGCGTATG
GCGCCCTCAAGAGCACCAC -> CGCCCTCAAGAGCACCACT
GCGCGATTCCTAGTCATCG -> CGCGATTCCTAGTCATCGC
GCGCGCAAACATGAGGCGT -> CGCGCAAACATGAGGCGTA
GCGCGTGCCCACCGCAAAA -> CGCGTGCCCACCGCAAAAC
GCGCTGTTTCTCGAAAAAT -> CGCTGTTTCTCGAAAAATA
GCGCTTACCAGCCATGAAC -> CGCTTACCAGCCATGAACG
GCGGACCTTGTCCATGTCG -> CGGACCTTGTCCATGTCGC
GCGGCTACCGACTTCTTGG -> CGGCTACCGACTTCTTGGG
GCGGGGGTCAACGCATCCT -> CGGGGGTCAACGCATCCTT
GCGGGGTCGCTCCACGCGA -> CGGGGTCGCTCCACGCGAG
GCGGTATCTGGGTAGGAAC -> CGGTATCTGGGTAGGAACG
GCGGTCTAATTTATTGATA -> CGGTCTAATTTATTGATAG
GCGGTGATGACCTAACTCT -> CGGTGATGACCTAACTCTA
GCGGTTTGCATAGAGCAGT -> CGGTTTGCATAGAGCAGTA
GCGTAGAAGTTCCCACACA -> CGTAGAAGTTCCCACACAG
GCGTATGAGTCAGCTCGGG -> CGTATGAGTCAGCTCGGGC
GCGTCAATTTCGCACAATC -> CGTCAATTTCGCACAATCA
GCGTGCCCACCGCAAAACA -> CGTGCCCACCGCAAAACAC
GCGTTCAAAAATACGGTTC -> CGTTCAAAAATACGGTTCC
GCGTTGACAAGCAAAACGT -> CGTTGACAAGCAAAACGTG
GCTAAAGGGCGAAAACCAA -> CTAAAGGGCGAAAACCAAA
GCTAACCAAAGTACACGCA -> CTAACCAAAGTACACGCAC
GCTACCGACTTCTTGGGAT -> CTACCGACTTCTTGGGATA
GCTACCGCGGTCTAATTTA -> CTACCGCGGTCTAATTTAT
GCTACTATGCCGTTTCATC -> CTACTATGCCGTTTCATCC
GCTACTCTTTGTAATCAGC -> CTACTCTTTGTAATCAGCA
GCTAGCCGTCGAGCCCTAT -> CTAGCCGTCGAGCCCTATC
GCTATATGTCGTGTTCTAG -> CTATATGTCGTGTTCTAGT
GCTATCTTAACCCGTTCCA -> CTATCTTAACCCGTTCCAC
GCTATGTTCTCTGTGTAGG -> CTATGTTCTCTGTGTAGGC
GCTATTCTATCACGCTGTA -> CTATTCTATCACGCTGTAA
GCTCCACGCGAGAGCTTGT -> CTCCACGCGAGAGCTTGTC
GCTCCCTACATGGTATAGT -> CTCCCTACATGGTATAGTA
GCTCCTAACTCCGGTGTCT -> CTCCTAACTCCGGTGTCTC
GCTCGACAAACCGAATGAC -> CTCGACAAACCGAATGACA
GCTCGGGCGAAATCTGTCG -> CTCGGGCGAAATCTGTCGG
GCTCTGCTGATAGCTTACG -> CTCTGCTGATAGCTTACGT
GCTGACGTCGTCAACTTGC -> CTGACGTCGTCAACTTGCC
GCTGAGCTTGTGAATTACG -> CTGAGCTTGTGAATTACGC
GCTGATAGCTTACGTATCC -> CTGATAGCTTACGTATCCC
GCTGGAGGCATGCGAGCTT -> CTGGAGGCATGCGAGCTTA
GCTGGGATATATATACATA -> CTGGGATATATATACATAT
GCTGTAAGAGTCGAGCGTT -> CTGTAAGAGTCGAGCGTTG
GCTGTTTCTCGAAAAATAG -> CTGTTTCTCGAAAAATAGT
GCTTACCAGCCATGAACGA -> CTTACCAGCCATGAACGAC
GCTTACCGTCAGTTTCCCC -> CTTACCGTCAGTTTCCCCA
GCTTACGTATCCCCTTTGA -> CTTACGTATCCCCTTTGAC
GCTTCCTCCAAACTAAACT -> CTTCCTCCAAACTAAACTT
GCTTCTCTATTAGTGCGAC -> CTTCTCTATTAGTGCGACC
GCTTGACTAAGTCTCGGAA -> CTTGACTAAGTCTCGGAAA
GCTTGACTATGGCTACTCT -> CTTGACTATGGCTACTCTT
GCTTGCACGGCATGCTCCC -> CTTGCACGGCATGCTCCCT
GCTTGCCTGAAACGGGCAT -> CTTGCCTGAAACGGGCATG
GCTTGTCTATCGGCAAATG -> CTTGTCTATCGGCAAATGA
GCTTGTGAATTACGCTCGA -> CTTGTGAATTACGCTCGAC
GCTTGTGTGGAATGTGTGT -> CTTGTGTGGAATGTGTGTG
GCTTTGGCTCCTAACTCCG -> CTTTGGCTCCTAACTCCGG
GGAAATGACACCGATAGTT -> GAAATGACACCGATAGTTG
GGAACCCCGCGGGGGTCAA -> GAACCCCGCGGGGGTCAAC
GGAACGAACCCTTGCCTGA -> GAACGAACCCTTGCCTGAA
GGAAGAGTCATCGTCTGGA -> GAAGAGTCATCGTCTGGAG
GGAATGTGTGTGGCCCTAC -> GAATGTGTGTGGCCCTACT
GGAATTCATAGCGTCAATT -> GAATTCATAGCGTCAATTT
GGACACTAGCCGTGGGTCG -> GACACTAGCCGTGGGTCGA
GGACATGTACCAGTCTCGG -> GACATGTACCAGTCTCGGA
GGACCGCGATGGTCAAATT -> GACCGCGATGGTCAAATTT
GGACCTTGTCCATGTCGCC -> GACCTTGTCCATGTCGCCC
GGACTGCGATCTCTCGAAC -> GACTGCGATCTCTCGAACG
GGACTTAGGGATGACAGCG -> GACTTAGGGATGACAGCGA
GGAGAACAGCGTTCAAAAA -> GAGAACAGCGTTCAAAAAT
GGAGACCCAGAATTGCATT -> GAGACCCAGAATTGCATTG
GGAGAGCGCTGTTTCTCGA -> GAGAGCGCTGTTTCTCGAA
GGAGAGTGCTTGACTAAGT -> GAGAGTGCTTGACTAAGTC
GGAGCTATATGTCGTGTTC -> GAGCTATATGTCGTGTTCT
GGAGGCATGCGAGCTTACC -> GAGGCATGCGAGCTTACCG
GGAGGCGAAATGGAATTCA -> GAGGCGAAATGGAATTCAT
GGAGTATACTGAATATTCG -> GAGTATACTGAATATTCGG
GGAGTCCGGGCTTGACTAT -> GAGTCCGGGCTTGACTATG
GGAGTGCAGTCTTAGGAGT -> GAGTGCAGTCTTAGGAGTA
GGATAAAAACTCAACTATA -> GATAAAAACTCAACTATAA
GGATACTTATTTTGTGACA -> GATACTTATTTTGTGACAG
GGATATATATACATATTCG -> GATATATATACATATTCGC
GGATATTTAGTGCGCGTGC -> GATATTTAGTGCGCGTGCC
GGATCAACTAAGTGAGGCA -> GATCAACTAAGTGAGGCAG
GGATGACAGCGACTACGGC -> GATGACAGCGACTACGGCC
GGATGATGCAACAGAAAAT -> GATGATGCAACAGAAAATC
GGATGCGACGAGGAGACCC -> GATGCGACGAGGAGACCCA
GGATTACATGTAACTGCTA -> GATTACATGTAACTGCTAT
GGATTCTATCCTGGCACAT -> GATTCTATCCTGGCACATC
GGCAAATGATTGGATAAAA -> GCAAATGATTGGATAAAAA
GGCAAGCCCGAAAGATCTT -> GCAAGCCCGAAAGATCTTC
GGCACATCTCCATTGCCAC -> GCACATCTCCATTGCCACC
GGCACCATCGTGTGGTCAT -> GCACCATCGTGTGGTCATT
GGCAGACGTCTAGGTTCCA -> GCAGACGTCTAGGTTCCAA
GGCAGAGGCTAACCAAAGT -> GCAGAGGCTAACCAAAGTA
GGCAGGATTCTATCCTGGC -> GCAGGATTCTATCCTGGCA
GGCATATATCCGCAGAGTT -> GCATATATCCGCAGAGTTT
GGCATCGGCGAGGTTCGTT -> GCATCGGCGAGGTTCGTTT
GGCATGCGAGCTTACCGTC -> GCATGCGAGCTTACCGTCA
GGCATGCTCCCTACATGGT -> GCATGCTCCCTACATGGTA
GGCATGGATGATGCAACAG -> GCATGGATGATGCAACAGA
GGCATGGGAGAGCGCTGTT -> GCATGGGAGAGCGCTGTTT
GGCATTATGTGTCTAGGTT -> GCATTATGTGTCTAGGTTT
GGCATTTGTTGTATAATTG -> GCATTTGTTGTATAATTGT
GGCCCAATTGCTACCGCGG -> GCCCAATTGCTACCGCGGT
GGCCCTACTCGAGGGGATG -> GCCCTACTCGAGGGGATGC
GGCCTAGTTTGTTCTTGAT -> GCCTAGTTTGTTCTTGATC
GGCGAAAACCAAATTCGGA -> GCGAAAACCAAATTCGGAA
GGCGAAATCTGTCGGTTAG -> GCGAAATCTGTCGGTTAGC
GGCGAAATGGAATTCATAG -> GCGAAATGGAATTCATAGC
GGCGACTTTTGTAACAATT -> GCGACTTTTGTAACAATTC
GGCGAGGTTCGTTTCTCGA -> GCGAGGTTCGTTTCTCGAA
GGCGATTGACTTGGAGTGC -> GCGATTGACTTGGAGTGCA
GGCGCGCAAACATGAGGCG -> GCGCGCAAACATGAGGCGT
GGCGCTTACCAGCCATGAA -> GCGCTTACCAGCCATGAAC
GGCGGTATCTGGGTAGGAA -> GCGGTATCTGGGTAGGAAC
GGCGGTTTGCATAGAGCAG -> GCGGTTTGCATAGAGCAGT
GGCGTATGAGTCAGCTCGG -> GCGTATGAGTCAGCTCGGG
GGCTAACCAAAGTACACGC -> GCTAACCAAAGTACACGCA
GGCTACCGACTTCTTGGGA -> GCTACCGACTTCTTGGGAT
GGCTACTCTTTGTAATCAG -> GCTACTCTTTGTAATCAGC
GGCTCCTAACTCCGGTGTC -> GCTCCTAACTCCGGTGTCT
GGCTTGACTATGGCTACTC -> GCTTGACTATGGCTACTCT
GGGAAATGACACCGATAGT -> GGAAATGACACCGATAGTT
GGGACATGTACCAGTCTCG -> GGACATGTACCAGTCTCGG
GGGAGAGCGCTGTTTCTCG -> GGAGAGCGCTGTTTCTCGA
GGGATACTTATTTTGTGAC -> GGATACTTATTTTGTGACA
GGGATATATATACATATTC -> GGATATATATACATATTCG
GGGATGACAGCGACTACGG -> GGATGACAGCGACTACGGC
GGGATGCGACGAGGAGACC -> GGATGCGACGAGGAGACCC
GGGCACCATCGTGTGGTCA -> GGCACCATCGTGTGGTCAT
GGGCAGAGGCTAACCAAAG -> GGCAGAGGCTAACCAAAGT
GGGCATATATCCGCAGAGT -> GGCATATATCCGCAGAGTT
GGGCATCGGCGAGGTTCGT -> GGCATCGGCGAGGTTCGTT
GGGCATGGGAGAGCGCTGT -> GGCATGGGAGAGCGCTGTT
GGGCATTATGTGTCTAGGT -> GGCATTATGTGTCTAGGTT
GGGCGAAAACCAAATTCGG -> GGCGAAAACCAAATTCGGA
GGGCGAAATCTGTCGGTTA -> GGCGAAATCTGTCGGTTAG
GGGCTTGACTATGGCTACT -> GGCTTGACTATGGCTACTC
GGGGAAATGACACCGATAG -> GGGAAATGACACCGATAGT
GGGGATGCGACGAGGAGAC -> GGGATGCGACGAGGAGACC
GGGGCACCATCGTGTGGTC -> GGGCACCATCGTGTGGTCA
GGGGCAGAGGCTAACCAAA -> GGGCAGAGGCTAACCAAAG
GGGGGCAGAGGCTAACCAA -> GGGGCAGAGGCTAACCAAA
GGGGGTCAACGCATCCTTG -> GGGGTCAACGCATCCTTGA
GGGGTCAACGCATCCTTGA -> GGGTCAACGCATCCTTGAC
GGGGTCGCTCCACGCGAGA -> GGGTCGCTCCACGCGAGAG
GGGTAGGAACGAACCCTTG -> GGTAGGAACGAACCCTTGC
GGGTCAACGCATCCTTGAC -> GGTCAACGCATCCTTGACT
GGGTCGAGTATTCGACTCT -> GGTCGAGTATTCGACTCTG
GGGTCGCTCCACGCGAGAG -> GGTCGCTCCACGCGAGAGC
GGGTGGATCAACTAAGTGA -> GGTGGATCAACTAAGTGAG
GGGTGTTGCTAAAGGGCGA -> GGTGTTGCTAAAGGGCGAA
GGTAGGAACGAACCCTTGC -> GTAGGAACGAACCCTTGCC
GGTATAGTACATATAGGTT -> GTATAGTACATATAGGTTC
GGTATCAGGGGGCAGAGGC -> GTATCAGGGGGCAGAGGCT
GGTATCTGGGTAGGAACGA -> GTATCTGGGTAGGAACGAA
GGTCAAATTTAACCTCCTC -> GTCAAATTTAACCTCCTCA
GGTCAACGCATCCTTGACT -> GTCAACGCATCCTTGACTG
GGTCATTCAACGGAAGAGT -> GTCATTCAACGGAAGAGTC
GGTCCTTCTATTGGGACAT -> GTCCTTCTATTGGGACATG
GGTCGACGATTTAATCGTA -> GTCGACGATTTAATCGTAA
GGTCGAGTATTCGACTCTG -> GTCGAGTATTCGACTCTGA
GGTCGCTCCACGCGAGAGC -> GTCGCTCCACGCGAGAGCT
GGTCTAATTTATTGATAGA -> GTCTAATTTATTGATAGAC
GGTGATAGCGATTCTGTCG -> GTGATAGCGATTCTGTCGG
GGTGATGACCTAACTCTAC -> GTGATGACCTAACTCTACC
GGTGGATCAACTAAGTGAG -> GTGGATCAACTAAGTGAGG
GGTGTCTCTTCGCCGTAGT -> GTGTCTCTTCGCCGTAGTC
GGTGTTGCTAAAGGGCGAA -> GTGTTGCTAAAGGGCGAAA
GGTTAGCCCTTCGATCAAT -> GTTAGCCCTTCGATCAATG
GGTTCCAATCAATGTGCTA -> GTTCCAATCAATGTGCTAT
GGTTCCACATAATACTTCA -> GTTCCACATAATACTTCAC
GGTTCGTTTCTCGAAAAAT -> GTTCGTTTCTCGAAAAATA
GGTTCTTGCCTGAAACGGG -> GTTCTTGCCTGAAACGGGC
GGTTGCTTGTGTGGAATGT -> GTTGCTTGTGTGGAATGTG
GGTTTCTCGAAAAATAGTC -> GTTTCTCGAAAAATAGTCA
GGTTTGCATAGAGCAGTAC -> GTTTGCATAGAGCAGTACG
GTAAAGCTTGCACGGCATG -> TAAAGCTTGCACGGCATGC
GTAACAATTCTTTAGATGT -> TAACAATTCTTTAGATGTG
GTAACTGCTATTCTATCAC -> TAACTGCTATTCTATCACG
GTAAGAGTCGAGCGTTGAC -> TAAGAGTCGAGCGTTGACA
GTAATCAGCACCAGTTACT -> TAATCAGCACCAGTTACTT
GTACACGCACAATTGTATC -> TACACGCACAATTGTATCA
GTACATATAGGTTCTTGCC -> TACATATAGGTTCTTGCCT
GTACCAGTCTCGGATTACA -> TACCAGTCTCGGATTACAT
GTACCGGTCCTTCTATTGG -> TACCGGTCCTTCTATTGGG
GTACGACTTCCTTTGGCGC -> TACGACTTCCTTTGGCGCT
GTACGCAGCAATCACACCC -> TACGCAGCAATCACACCCT
GTACGTTCGGCGATTGACT -> TACGTTCGGCGATTGACTT
GTAGAAGTTCCCACACAGC -> TAGAAGTTCCCACACAGCC
GTAGGAACGAACCCTTGCC -> TAGGAACGAACCCTTGCCT
GTAGGCATTTGTTGTATAA -> TAGGCATTTGTTGTATAAT
GTAGTCGATCGCTGACGTC -> TAGTCGATCGCTGACGTCG
GTATAATTGTACCGGTCCT -> TATAATTGTACCGGTCCTT
GTATACTGAATATTCGGAG -> TATACTGAATATTCGGAGA
GTATAGTACATATAGGTTC -> TATAGTACATATAGGTTCT
GTATCAAAACCGGAGGCGA -> TATCAAAACCGGAGGCGAA
GTATCAGGGGGCAGAGGCT -> TATCAGGGGGCAGAGGCTA
GTATCCCCTTTGACCTATT -> TATCCCCTTTGACCTATTA
GTATCTGGGTAGGAACGAA -> TATCTGGGTAGGAACGAAC
GTATGAGTCAGCTCGGGCG -> TATGAGTCAGCTCGGGCGA
GTATTCGACTCTGACTAAC -> TATTCGACTCTGACTAACT
GTCAAATTTAACCTCCTCA -> TCAAATTTAACCTCCTCAG
GTCAACGCATCCTTGACTG -> TCAACGCATCCTTGACTGT
GTCAACTTGCCTGAAACGG -> TCAACTTGCCTGAAACGGG
GTCAATGCCCCTGGGTGTT -> TCAATGCCCCTGGGTGTTG
GTCAATTTCGCACAATCAG -> TCAATTTCGCACAATCAGC
GTCACCTGTGGCGGTTTGC -> TCACCTGTGGCGGTTTGCA
GTCACTTGCACTCCTGGCC -> TCACTTGCACTCCTGGCCT
GTCAGCTCGGGCGAAATCT -> TCAGCTCGGGCGAAATCTG
GTCAGGCAGACGTCTAGGT -> TCAGGCAGACGTCTAGGTT
GTCAGTTTCCCCACTATGG -> TCAGTTTCCCCACTATGGC
GTCATCGCTCTGCTGATAG -> TCATCGCTCTGCTGATAGC
GTCATCGTCTGGAGCTATA -> TCATCGTCTGGAGCTATAT
GTCATTCAACGGAAGAGTC -> TCATTCAACGGAAGAGTCA
GTCCATGTCGCCCCAGTGA -> TCCATGTCGCCCCAGTGAC
GTCCGGGCTTGACTATGGC -> TCCGGGCTTGACTATGGCT
GTCCTGCCTGTCTCGTTTC -> TCCTGCCTGTCTCGTTTCA
GTCCTTCTATTGGGACATG -> TCCTTCTATTGGGACATGT
GTCCTTCTTAAGAGCACGC -> TCCTTCTTAAGAGCACGCC
GTCGACGATTTAATCGTAA -> TCGACGATTTAATCGTAAA
GTCGAGCCCTATCTTATAT -> TCGAGCCCTATCTTATATC
GTCGAGCGTTGACAAGCAA -> TCGAGCGTTGACAAGCAAA
GTCGAGTATTCGACTCTGA -> TCGAGTATTCGACTCTGAC
GTCGATCGCTGACGTCGTC -> TCGATCGCTGACGTCGTCA
GTCGCCCCAGTGACCTAAC -> TCGCCCCAGTGACCTAACG
GTCGCTCCACGCGAGAGCT -> TCGCTCCACGCGAGAGCTT
GTCGGCGGTATCTGGGTAG -> TCGGCGGTATCTGGGTAGG
GTCGGTTAGCCCTTCGATC -> TCGGTTAGCCCTTCGATCA
GTCGTCAACTTGCCTGAAA -> TCGTCAACTTGCCTGAAAC
GTCGTGTTCTAGTGCGGTG -> TCGTGTTCTAGTGCGGTGA
GTCTAATTTATTGATAGAC -> TCTAATTTATTGATAGACA
GTCTAGGTTCCAATCAATG -> TCTAGGTTCCAATCAATGT
GTCTAGGTTTCTCGAAAAA -> TCTAGGTTTCTCGAAAAAT
GTCTATCGGCAAATGATTG -> TCTATCGGCAAATGATTGG
GTCTCGGATTACATGTAAC -> TCTCGGATTACATGTAACT
GTCTCGTTTCAGCAGTCTG -> TCTCGTTTCAGCAGTCTGC
GTCTCTTCGCCGTAGTCGA -> TCTCTTCGCCGTAGTCGAT
GTCTGCGGCTACCGACTTC -> TCTGCGGCTACCGACTTCT
GTCTGGAGCTATATGTCGT -> TCTGGAGCTATATGTCGTG
GTCTTAGGAGTATACTGAA -> TCTTAGGAGTATACTGAAT
GTGAATTACGCTCGACAAA -> TGAATTACGCTCGACAAAC
GTGACAGTGGTCGACGATT -> TGACAGTGGTCGACGATTT
GTGACCTAACGGTTGCTTG -> TGACCTAACGGTTGCTTGT
GTGAGGCAGGATTCTATCC -> TGAGGCAGGATTCTATCCT
GTGATAGCGATTCTGTCGG -> TGATAGCGATTCTGTCGGC
GTGATGACCTAACTCTACC -> TGATGACCTAACTCTACCA
GTGCAGTCTTAGGAGTATA -> TGCAGTCTTAGGAGTATAC
GTGCCCACCGCAAAACACG -> TGCCCACCGCAAAACACGC
GTGCCGCCTGTCCTTCTTA -> TGCCGCCTGTCCTTCTTAA
GTGCGACCCACGGACCGCG -> TGCGACCCACGGACCGCGA
GTGCGCGTGCCCACCGCAA -> TGCGCGTGCCCACCGCAAA
GTGCGGTGATGACCTAACT -> TGCGGTGATGACCTAACTC
GTGCTATCTTAACCCGTTC -> TGCTATCTTAACCCGTTCC
GTGCTTGACTAAGTCTCGG -> TGCTTGACTAAGTCTCGGA
GTGGAATGTGTGTGGCCCT -> TGGAATGTGTGTGGCCCTA
GTGGACACTAGCCGTGGGT -> TGGACACTAGCCGTGGGTC
GTGGACTGCGATCTCTCGA -> TGGACTGCGATCTCTCGAA
GTGGATCAACTAAGTGAGG -> TGGATCAACTAAGTGAGGC
GTGGCCCTACTCGAGGGGA -> TGGCCCTACTCGAGGGGAT
GTGGCGGTTTGCATAGAGC -> TGGCGGTTTGCATAGAGCA
GTGGGTCGAGTATTCGACT -> TGGGTCGAGTATTCGACTC
GTGGTCATTCAACGGAAGA -> TGGTCATTCAACGGAAGAG
GTGGTCGACGATTTAATCG -> TGGTCGACGATTTAATCGT
GTGTAGGCATTTGTTGTAT -> TGTAGGCATTTGTTGTATA
GTGTCTAGGTTTCTCGAAA -> TGTCTAGGTTTCTCGAAAA
GTGTCTCTTCGCCGTAGTC -> TGTCTCTTCGCCGTAGTCG
GTGTGGAATGTGTGTGGCC -> TGTGGAATGTGTGTGGCCC
GTGTGGCCCTACTCGAGGG -> TGTGGCCCTACTCGAGGGG
GTGTGGTCATTCAACGGAA -> TGTGGTCATTCAACGGAAG
GTGTGTGGCCCTACTCGAG -> TGTGTGGCCCTACTCGAGG
GTGTTCTAGTGCGGTGATG -> TGTTCTAGTGCGGTGATGA
GTGTTGACTATTGCTTGCC -> TGTTGACTATTGCTTGCCT
GTGTTGCTAAAGGGCGAAA -> TGTTGCTAAAGGGCGAAAA
GTTACCACTTGACAAGTGG -> TTACCACTTGACAAGTGGA
GTTACTTATGCTGAGCTTG -> TTACTTATGCTGAGCTTGT
GTTAGCCCTTCGATCAATG -> TTAGCCCTTCGATCAATGC
GTTCAAAAATACGGTTCCA -> TTCAAAAATACGGTTCCAC
GTTCCAATCAATGTGCTAT -> TTCCAATCAATGTGCTATC
GTTCCACATAATACTTCAC -> TTCCACATAATACTTCACA
GTTCCACGCGGACCTTGTC -> TTCCACGCGGACCTTGTCC
GTTCCCACACAGCCAAAGC -> TTCCCACACAGCCAAAGCA
GTTCGGCGATTGACTTGGA -> TTCGGCGATTGACTTGGAG
GTTCGTTTCTCGAAAAATA -> TTCGTTTCTCGAAAAATAG
GTTCTAGTGCGGTGATGAC -> TTCTAGTGCGGTGATGACC
GTTCTCTGTGTAGGCATTT -> TTCTCTGTGTAGGCATTTG
GTTCTTGATCTAGTGGACT -> TTCTTGATCTAGTGGACTG
GTTCTTGCCTGAAACGGGC -> TTCTTGCCTGAAACGGGCA
GTTGACAAGCAAAACGTGT -> TTGACAAGCAAAACGTGTT
GTTGACGGAGAACAGCGTT -> TTGACGGAGAACAGCGTTC
GTTGACTATTGCTTGCCTG -> TTGACTATTGCTTGCCTGA
GTTGCGCCCTCAAGAGCAC -> TTGCGCCCTCAAGAGCACC
GTTGCTAAAGGGCGAAAAC -> TTGCTAAAGGGCGAAAACC
GTTGCTTGTGTGGAATGTG -> TTGCTTGTGTGGAATGTGT
GTTGGTGATAGCGATTCTG -> TTGGTGATAGCGATTCTGT
GTTGTATAATTGTACCGGT -> TTGTATAATTGTACCGGTC
GTTTCAGCAGTCTGCGGCT -> TTTCAGCAGTCTGCGGCTA
GTTTCATCCTGCTTCCTCC -> TTTCATCCTGCTTCCTCCA
GTTTCCCCACTATGGCAAG -> TTTCCCCACTATGGCAAGC
GTTTCTCGAAAAATAGTCA -> TTTCTCGAAAAATAGTCAA,TTTCTCGAAAAATAGTCAG,TTTCTCGAAAAATAGTCAC,TTTCTCGAAAAATAGTCAC
GTTTGCATAGAGCAGTACG -> TTTGCATAGAGCAGTACGA
GTTTGTTCTTGATCTAGTG -> TTTGTTCTTGATCTAGTGG
GTTTTTTCGGCGACTTTTG -> TTTTTTCGGCGACTTTTGT
TAAAAACTCAACTATAACG -> AAAAACTCAACTATAACGT
TAAACTTTAGTACGCAGCA -> AAACTTTAGTACGCAGCAA
TAAAGCTTGCACGGCATGC -> AAAGCTTGCACGGCATGCT
TAAAGGGCGAAAACCAAAT -> AAAGGGCGAAAACCAAATT
TAAATGCTAGCCGTCGAGC -> AAATGCTAGCCGTCGAGCC
TAACAATTCTTTAGATGTG -> AACAATTCTTTAGATGTGC
TAACCAAAGTACACGCACA -> AACCAAAGTACACGCACAA
TAACCCGTTCCACGCGGAC -> AACCCGTTCCACGCGGACC
TAACCTCCTCAGTTTTTTC -> AACCTCCTCAGTTTTTTCG
TAACGGTTGCTTGTGTGGA -> AACGGTTGCTTGTGTGGAA
TAACGTTACCACTTGACAA -> AACGTTACCACTTGACAAG
TAACTCCGGTGTCTCTTCG -> AACTCCGGTGTCTCTTCGC
TAACTCTAAATGCTAGCCG -> AACTCTAAATGCTAGCCGT
TAACTCTACCACTTTTGGG -> AACTCTACCACTTTTGGGG
TAACTGCTATTCTATCACG -> AACTGCTATTCTATCACGC
TAAGAGCACGCCTGGATAT -> AAGAGCACGCCTGGATATT
TAAGAGTCGAGCGTTGACA -> AAGAGTCGAGCGTTGACAA
TAAGGCGCGCAAACATGAG -> AAGGCGCGCAAACATGAGG
TAAGGGTGGATCAACTAAG -> AAGGGTGGATCAACTAAGT
TAAGTGAGGCAGGATTCTA -> AAGTGAGGCAGGATTCTAT
TAATACTTCACAGTTGCGC -> AATACTTCACAGTTGCGCC
TAATCAGCACCAGTTACTT -> AATCAGCACCAGTTACTTA
TAATCAGGGGCACCATCGT -> AATCAGGGGCACCATCGTG
TAATCGTAAAGCTTGCACG -> AATCGTAAAGCTTGCACGG
TAATTGTACCGGTCCTTCT -> AATTGTACCGGTCCTTCTA
TAATTTATTGATAGACAAT -> AATTTATTGATAGACAATT
TACACGCACAATTGTATCA -> ACACGCACAATTGTATCAA
TACATATAGGTTCTTGCCT -> ACATATAGGTTCTTGCCTG
TACATATTCGCCACACCTA -> ACATATTCGCCACACCTAT
TACATGGTATAGTACATAT -> ACATGGTATAGTACATATA
TACATGTAACTGCTATTCT -> ACATGTAACTGCTATTCTA
TACCACTTGACAAGTGGAC -> ACCACTTGACAAGTGGACA
TACCACTTTTGGGGAAATG -> ACCACTTTTGGGGAAATGA
TACCAGCCATGAACGACAC -> ACCAGCCATGAACGACACA
TACCAGTCTCGGATTACAT -> ACCAGTCTCGGATTACATG
TACCGACTTCTTGGGATAC -> ACCGACTTCTTGGGATACT
TACCGCGGTCTAATTTATT -> ACCGCGGTCTAATTTATTG
TACCGGTCCTTCTATTGGG -> ACCGGTCCTTCTATTGGGA
TACCGTCAGTTTCCCCACT -> ACCGTCAGTTTCCCCACTA
TACGACTTCCTTTGGCGCT -> ACGACTTCCTTTGGCGCTT
TACGCAGCAATCACACCCT -> ACGCAGCAATCACACCCTA
TACGCTCGACAAACCGAAT -> ACGCTCGACAAACCGAATG
TACGGCCCAATTGCTACCG -> ACGGCCCAATTGCTACCGC
TACGGTTCCACATAATACT -> ACGGTTCCACATAATACTT
TACGTATCCCCTTTGACCT -> ACGTATCCCCTTTGACCTA
TACGTTCGGCGATTGACTT -> ACGTTCGGCGATTGACTTG
TACTATGCCGTTTCATCCT -> ACTATGCCGTTTCATCCTG
TACTCGAGGGGATGCGACG -> ACTCGAGGGGATGCGACGA
TACTCTTTGTAATCAGCAC -> ACTCTTTGTAATCAGCACC
TACTGAATATTCGGAGAGT -> ACTGAATATTCGGAGAGTG
TACTTATGCTGAGCTTGTG -> ACTTATGCTGAGCTTGTGA
TACTTATTTTGTGACAGTG -> ACTTATTTTGTGACAGTGG
TACTTCACAGTTGCGCCCT -> ACTTCACAGTTGCGCCCTC
TAGAAGTTCCCACACAGCC -> AGAAGTTCCCACACAGCCA
TAGACAATTTTCTTAATCA -> AGACAATTTTCTTAATCAG
TAGAGCAGTACGACTTCCT -> AGAGCAGTACGACTTCCTT
TAGAGTACGTTCGGCGATT -> AGAGTACGTTCGGCGATTG
TAGATGTGCCGCCTGTCCT -> AGATGTGCCGCCTGTCCTT
TAGCCCTTCGATCAATGCA -> AGCCCTTCGATCAATGCAC
TAGCCGTCGAGCCCTATCT -> AGCCGTCGAGCCCTATCTT
TAGCCGTGGGTCGAGTATT -> AGCCGTGGGTCGAGTATTC
TAGCGATTCTGTCGGCGGT -> AGCGATTCTGTCGGCGGTA
TAGCGTCAATTTCGCACAA -> AGCGTCAATTTCGCACAAT
TAGCTTACGTATCCCCTTT -> AGCTTACGTATCCCCTTTG
TAGGAACGAACCCTTGCCT -> AGGAACGAACCCTTGCCTG
TAGGAGTATACTGAATATT -> AGGAGTATACTGAATATTC
TAGGCATTTGTTGTATAAT -> AGGCATTTGTTGTATAATT
TAGGGATGACAGCGACTAC -> AGGGATGACAGCGACTACG
TAGGTTCCAATCAATGTGC -> AGGTTCCAATCAATGTGCT
TAGGTTCTTGCCTGAAACG -> AGGTTCTTGCCTGAAACGG
TAGGTTTCTCGAAAAATAG -> AGGTTTCTCGAAAAATAGT
TAGTACATATAGGTTCTTG -> AGTACATATAGGTTCTTGC
TAGTACGCAGCAATCACAC -> AGTACGCAGCAATCACACC
TAGTCAATGCCCCTGGGTG -> AGTCAATGCCCCTGGGTGT
TAGTCACCTGTGGCGGTTT -> AGTCACCTGTGGCGGTTTG
TAGTCACTTGCACTCCTGG -> AGTCACTTGCACTCCTGGC
TAGTCAGGCAGACGTCTAG -> AGTCAGGCAGACGTCTAGG
TAGTCATCGCTCTGCTGAT -> AGTCATCGCTCTGCTGATA
TAGTCGATCGCTGACGTCG -> AGTCGATCGCTGACGTCGT
TAGTGCGACCCACGGACCG -> AGTGCGACCCACGGACCGC
TAGTGCGCGTGCCCACCGC -> AGTGCGCGTGCCCACCGCA
TAGTGCGGTGATGACCTAA -> AGTGCGGTGATGACCTAAC
TAGTGGACTGCGATCTCTC -> AGTGGACTGCGATCTCTCG
TAGTTGACGGAGAACAGCG -> AGTTGACGGAGAACAGCGT
TAGTTTGTTCTTGATCTAG -> AGTTTGTTCTTGATCTAGT
TATAACGTTACCACTTGAC -> ATAACGTTACCACTTGACA
TATAAGGCGCGCAAACATG -> ATAAGGCGCGCAAACATGA
TATAATTGTACCGGTCCTT -> ATAATTGTACCGGTCCTTC
TATACATATTCGCCACACC -> ATACATATTCGCCACACCT
TATACTGAATATTCGGAGA -> ATACTGAATATTCGGAGAG
TATAGGTTCTTGCCTGAAA -> ATAGGTTCTTGCCTGAAAC
TATAGTACATATAGGTTCT -> ATAGTACATATAGGTTCTT
TATATACATATTCGCCACA -> ATATACATATTCGCCACAC
TATATATACATATTCGCCA -> ATATATACATATTCGCCAC
TATATCATGAGACGCTGGA -> ATATCATGAGACGCTGGAG
TATATCCGCAGAGTTTCTC -> ATATCCGCAGAGTTTCTCG
TATATCGCTGGGATATATA -> ATATCGCTGGGATATATAT
TATATGTCGTGTTCTAGTG -> ATATGTCGTGTTCTAGTGC
TATCAAAACCGGAGGCGAA -> ATCAAAACCGGAGGCGAAA
TATCACGCTGTAAGAGTCG -> ATCACGCTGTAAGAGTCGA
TATCACTTTTGCGGGGTCG -> ATCACTTTTGCGGGGTCGC
TATCAGGGGGCAGAGGCTA -> ATCAGGGGGCAGAGGCTAA
TATCATGAGACGCTGGAGG -> ATCATGAGACGCTGGAGGC
TATCCCCTTTGACCTATTA -> ATCCCCTTTGACCTATTAT
TATCCGCAGAGTTTCTCGA -> ATCCGCAGAGTTTCTCGAA
TATCCGCTTCTCTATTAGT -> ATCCGCTTCTCTATTAGTG
TATCCTGGCACATCTCCAT -> ATCCTGGCACATCTCCATT
TATCGCTGGGATATATATA -> ATCGCTGGGATATATATAC
TATCGGCAAATGATTGGAT -> ATCGGCAAATGATTGGATA
TATCTGGGTAGGAACGAAC -> ATCTGGGTAGGAACGAACC
TATCTTAACCCGTTCCACG -> ATCTTAACCCGTTCCACGC
TATCTTATATCGCTGGGAT -> ATCTTATATCGCTGGGATA
TATGAGTCAGCTCGGGCGA -> ATGAGTCAGCTCGGGCGAA
TATGCCGTTTCATCCTGCT -> ATGCCGTTTCATCCTGCTT
TATGCTGAGCTTGTGAATT -> ATGCTGAGCTTGTGAATTA
TATGGCAAGCCCGAAAGAT -> ATGGCAAGCCCGAAAGATC
TATGGCTACTCTTTGTAAT -> ATGGCTACTCTTTGTAATC
TATGTCGTGTTCTAGTGCG -> ATGTCGTGTTCTAGTGCGG
TATGTGTCTAGGTTTCTCG -> ATGTGTCTAGGTTTCTCGA
TATGTTCTCTGTGTAGGCA -> ATGTTCTCTGTGTAGGCAT
TATTAGTGCGACCCACGGA -> ATTAGTGCGACCCACGGAC
TATTATAAGGCGCGCAAAC -> ATTATAAGGCGCGCAAACA
TATTCGACTCTGACTAACT -> ATTCGACTCTGACTAACTC
TATTCGCCACACCTATATC -> ATTCGCCACACCTATATCA
TATTCGGAGAGTGCTTGAC -> ATTCGGAGAGTGCTTGACT
TATTCTATCACGCTGTAAG -> ATTCTATCACGCTGTAAGA
TATTGATAGACAATTTTCT -> ATTGATAGACAATTTTCTT
TATTGCTTGCCTGAAACGG -> ATTGCTTGCCTGAAACGGG
TATTGGGACATGTACCAGT -> ATTGGGACATGTACCAGTC
TATTTAGTGCGCGTGCCCA -> ATTTAGTGCGCGTGCCCAC
TATTTTGTGACAGTGGTCG -> ATTTTGTGACAGTGGTCGA
TCAAAAATACGGTTCCACA -> CAAAAATACGGTTCCACAT
TCAAAACCGGAGGCGAAAT -> CAAAACCGGAGGCGAAATG
TCAAAACCTGCGTAGAAGT -> CAAAACCTGCGTAGAAGTT
TCAAATTTAACCTCCTCAG -> CAAATTTAACCTCCTCAGT
TCAACGCATCCTTGACTGT -> CAACGCATCCTTGACTGTT
TCAACGGAAGAGTCATCGT -> CAACGGAAGAGTCATCGTC
TCAACTAAGTGAGGCAGGA -> CAACTAAGTGAGGCAGGAT
TCAACTATAACGTTACCAC -> CAACTATAACGTTACCACT
TCAACTTGCCTGAAACGGG -> CAACTTGCCTGAAACGGGC
TCAAGAGCACCACTTAAGG -> CAAGAGCACCACTTAAGGG
TCAATGCACCGCTTTGGCT -> CAATGCACCGCTTTGGCTC
TCAATGCCCCTGGGTGTTG -> CAATGCCCCTGGGTGTTGC
TCAATGTGCTATCTTAACC -> CAATGTGCTATCTTAACCC
TCAATTTCGCACAATCAGC -> CAATTTCGCACAATCAGCT
TCACACCCTATCCGCTTCT -> CACACCCTATCCGCTTCTC
TCACAGTTGCGCCCTCAAG -> CACAGTTGCGCCCTCAAGA
TCACCTGTGGCGGTTTGCA -> CACCTGTGGCGGTTTGCAT
TCACGCTGTAAGAGTCGAG -> CACGCTGTAAGAGTCGAGC
TCACTTGCACTCCTGGCCT -> CACTTGCACTCCTGGCCTA
TCACTTTTGCGGGGTCGCT -> CACTTTTGCGGGGTCGCTC
TCAGCACCAGTTACTTATG -> CAGCACCAGTTACTTATGC
TCAGCAGTCTGCGGCTACC -> CAGCAGTCTGCGGCTACCG
TCAGCTACTATGCCGTTTC -> CAGCTACTATGCCGTTTCA
TCAGCTCGGGCGAAATCTG -> CAGCTCGGGCGAAATCTGT
TCAGGCAGACGTCTAGGTT -> CAGGCAGACGTCTAGGTTC
TCAGGGGCACCATCGTGTG -> CAGGGGCACCATCGTGTGG
TCAGGGGGCAGAGGCTAAC -> CAGGGGGCAGAGGCTAACC
TCAGTTTCCCCACTATGGC -> CAGTTTCCCCACTATGGCA
TCAGTTTTTTCGGCGACTT -> CAGTTTTTTCGGCGACTTT
TCATAGCGTCAATTTCGCA -> CATAGCGTCAATTTCGCAC
TCATCCTGCTTCCTCCAAA -> CATCCTGCTTCCTCCAAAC
TCATCGCTCTGCTGATAGC -> CATCGCTCTGCTGATAGCT
TCATCGTCTGGAGCTATAT -> CATCGTCTGGAGCTATATG
TCATGAGACGCTGGAGGCA -> CATGAGACGCTGGAGGCAT
TCATTCAACGGAAGAGTCA -> CATTCAACGGAAGAGTCAT
TCCAAACTAAACTTTAGTA -> CCAAACTAAACTTTAGTAC
TCCAATCAATGTGCTATCT -> CCAATCAATGTGCTATCTT
TCCACATAATACTTCACAG -> CCACATAATACTTCACAGT
TCCACGCGAGAGCTTGTCT -> CCACGCGAGAGCTTGTCTA
TCCACGCGGACCTTGTCCA -> CCACGCGGACCTTGTCCAT
TCCATGTCGCCCCAGTGAC -> CCATGTCGCCCCAGTGACC
TCCATTGCCACCATTTTGG -> CCATTGCCACCATTTTGGC
TCCCACACAGCCAAAGCAC -> CCCACACAGCCAAAGCACC
TCCCCACTATGGCAAGCCC -> CCCCACTATGGCAAGCCCG
TCCCCTTTGACCTATTATA -> CCCCTTTGACCTATTATAA
TCCCTACATGGTATAGTAC -> CCCTACATGGTATAGTACA
TCCGCAGAGTTTCTCGAAA -> CCGCAGAGTTTCTCGAAAA
TCCGCTTCTCTATTAGTGC -> CCGCTTCTCTATTAGTGCG
TCCGGGCTTGACTATGGCT -> CCGGGCTTGACTATGGCTA
TCCGGTGTCTCTTCGCCGT -> CCGGTGTCTCTTCGCCGTA
TCCTAACTCCGGTGTCTCT -> CCTAACTCCGGTGTCTCTT
TCCTAGTCATCGCTCTGCT -> CCTAGTCATCGCTCTGCTG
TCCTCAGTTTTTTCGGCGA -> CCTCAGTTTTTTCGGCGAC
TCCTCCAAACTAAACTTTA -> CCTCCAAACTAAACTTTAG
TCCTGCCTGTCTCGTTTCA -> CCTGCCTGTCTCGTTTCAG
TCCTGCTATGTTCTCTGTG -> CCTGCTATGTTCTCTGTGT
TCCTGCTTCCTCCAAACTA -> CCTGCTTCCTCCAAACTAA
TCCTGGCACATCTCCATTG -> CCTGGCACATCTCCATTGC
TCCTGGCCTAGTTTGTTCT -> CCTGGCCTAGTTTGTTCTT
TCCTTCTATTGGGACATGT -> CCTTCTATTGGGACATGTA
TCCTTCTTAAGAGCACGCC -> CCTTCTTAAGAGCACGCCT
TCCTTGACTGTTGGTGATA -> CCTTGACTGTTGGTGATAG
TCCTTTGGCGCTTACCAGC -> CCTTTGGCGCTTACCAGCC
TCGAAAAATAGTCAATGCC -> CGAAAAATAGTCAATGCCC
TCGAAAAATAGTCACCTGT -> CGAAAAATAGTCACCTGTG
TCGAAAAATAGTCACTTGC -> CGAAAAATAGTCACTTGCA
TCGAAAAATAGTCAGGCAG -> CGAAAAATAGTCAGGCAGA
TCGAACGCCGATGTCCTGC -> CGAACGCCGATGTCCTGCC
TCGACAAACCGAATGACAT -> CGACAAACCGAATGACATC
TCGACGATTTAATCGTAAA -> CGACGATTTAATCGTAAAG
TCGACTCTGACTAACTCTA -> CGACTCTGACTAACTCTAA
TCGAGCCCTATCTTATATC -> CGAGCCCTATCTTATATCG
TCGAGCGTTGACAAGCAAA -> CGAGCGTTGACAAGCAAAA
TCGAGGGGATGCGACGAGG -> CGAGGGGATGCGACGAGGA
TCGAGTATTCGACTCTGAC -> CGAGTATTCGACTCTGACT
TCGATCAATGCACCGCTTT -> CGATCAATGCACCGCTTTG
TCGATCGCTGACGTCGTCA -> CGATCGCTGACGTCGTCAA
TCGCACAATCAGCTACTAT -> CGCACAATCAGCTACTATG
TCGCCACACCTATATCATG -> CGCCACACCTATATCATGA
TCGCCCCAGTGACCTAACG -> CGCCCCAGTGACCTAACGG
TCGCCGTAGTCGATCGCTG -> CGCCGTAGTCGATCGCTGA
TCGCTCCACGCGAGAGCTT -> CGCTCCACGCGAGAGCTTG
TCGCTCTGCTGATAGCTTA -> CGCTCTGCTGATAGCTTAC
TCGCTGACGTCGTCAACTT -> CGCTGACGTCGTCAACTTG
TCGCTGGGATATATATACA -> CGCTGGGATATATATACAT
TCGGAACCCCGCGGGGGTC -> CGGAACCCCGCGGGGGTCA
TCGGAGAGTGCTTGACTAA -> CGGAGAGTGCTTGACTAAG
TCGGATTACATGTAACTGC -> CGGATTACATGTAACTGCT
TCGGCAAATGATTGGATAA -> CGGCAAATGATTGGATAAA
TCGGCGACTTTTGTAACAA -> CGGCGACTTTTGTAACAAT
TCGGCGAGGTTCGTTTCTC -> CGGCGAGGTTCGTTTCTCG
TCGGCGATTGACTTGGAGT -> CGGCGATTGACTTGGAGTG
TCGGCGGTATCTGGGTAGG -> CGGCGGTATCTGGGTAGGA
TCGGGCGAAATCTGTCGGT -> CGGGCGAAATCTGTCGGTT
TCGGTTAGCCCTTCGATCA -> CGGTTAGCCCTTCGATCAA
TCGTAAAGCTTGCACGGCA -> CGTAAAGCTTGCACGGCAT
TCGTCAACTTGCCTGAAAC -> CGTCAACTTGCCTGAAACG
TCGTCTGGAGCTATATGTC -> CGTCTGGAGCTATATGTCG
TCGTGTGGTCATTCAACGG -> CGTGTGGTCATTCAACGGA
TCGTGTTCTAGTGCGGTGA -> CGTGTTCTAGTGCGGTGAT
TCGTTTCAGCAGTCTGCGG -> CGTTTCAGCAGTCTGCGGC
TCGTTTCTCGAAAAATAGT -> CGTTTCTCGAAAAATAGTC
TCTAAATGCTAGCCGTCGA -> CTAAATGCTAGCCGTCGAG
TCTAATTTATTGATAGACA -> CTAATTTATTGATAGACAA
TCTACCACTTTTGGGGAAA -> CTACCACTTTTGGGGAAAT
TCTAGAGTACGTTCGGCGA -> CTAGAGTACGTTCGGCGAT
TCTAGGTTCCAATCAATGT -> CTAGGTTCCAATCAATGTG
TCTAGGTTTCTCGAAAAAT -> CTAGGTTTCTCGAAAAATA
TCTAGTGCGGTGATGACCT -> CTAGTGCGGTGATGACCTA
TCTAGTGGACTGCGATCTC -> CTAGTGGACTGCGATCTCT
TCTATCACGCTGTAAGAGT -> CTATCACGCTGTAAGAGTC
TCTATCCTGGCACATCTCC -> CTATCCTGGCACATCTCCA
TCTATCGGCAAATGATTGG -> CTATCGGCAAATGATTGGA
TCTATTAGTGCGACCCACG -> CTATTAGTGCGACCCACGG
TCTATTGGGACATGTACCA -> CTATTGGGACATGTACCAG
TCTCCATTGCCACCATTTT -> CTCCATTGCCACCATTTTG
TCTCCTGCTATGTTCTCTG -> CTCCTGCTATGTTCTCTGT
TCTCGAAAAATAGTCAATG -> CTCGAAAAATAGTCAATGC
TCTCGAAAAATAGTCACCT -> CTCGAAAAATAGTCACCTG
TCTCGAAAAATAGTCACTT -> CTCGAAAAATAGTCACTTG
TCTCGAAAAATAGTCAGGC -> CTCGAAAAATAGTCAGGCA
TCTCGAACGCCGATGTCCT -> CTCGAACGCCGATGTCCTG
TCTCGGATTACATGTAACT -> CTCGGATTACATGTAACTG
TCTCGTTTCAGCAGTCTGC -> CTCGTTTCAGCAGTCTGCG
TCTCTATTAGTGCGACCCA -> CTCTATTAGTGCGACCCAC
TCTCTCGAACGCCGATGTC -> CTCTCGAACGCCGATGTCC
TCTCTGTGTAGGCATTTGT -> CTCTGTGTAGGCATTTGTT
TCTCTTCGCCGTAGTCGAT -> CTCTTCGCCGTAGTCGATC
TCTGACTAACTCTAAATGC -> CTGACTAACTCTAAATGCT
TCTGCGGCTACCGACTTCT -> CTGCGGCTACCGACTTCTT
TCTGCTGATAGCTTACGTA -> CTGCTGATAGCTTACGTAT
TCTGGAGCTATATGTCGTG -> CTGGAGCTATATGTCGTGT
TCTGGGTAGGAACGAACCC -> CTGGGTAGGAACGAACCCT
TCTGTCGGCGGTATCTGGG -> CTGTCGGCGGTATCTGGGT
TCTGTCGGTTAGCCCTTCG -> CTGTCGGTTAGCCCTTCGA
TCTGTGTAGGCATTTGTTG -> CTGTGTAGGCATTTGTTGT
TCTTAACCCGTTCCACGCG -> CTTAACCCGTTCCACGCGG
TCTTAAGAGCACGCCTGGA -> CTTAAGAGCACGCCTGGAT
TCTTAATCAGGGGCACCAT -> CTTAATCAGGGGCACCATC
TCTTAGGAGTATACTGAAT -> CTTAGGAGTATACTGAATA
TCTTATATCGCTGGGATAT -> CTTATATCGCTGGGATATA
TCTTCAAAACCTGCGTAGA -> CTTCAAAACCTGCGTAGAA
TCTTCGCCGTAGTCGATCG -> CTTCGCCGTAGTCGATCGC
TCTTGATCTAGTGGACTGC -> CTTGATCTAGTGGACTGCG
TCTTGCCTGAAACGGGCAT -> CTTGCCTGAAACGGGCATT
TCTTGGGATACTTATTTTG -> CTTGGGATACTTATTTTGT
TCTTTAGATGTGCCGCCTG -> CTTTAGATGTGCCGCCTGT
TCTTTGTAATCAGCACCAG -> CTTTGTAATCAGCACCAGT
TGAAACGGGCATATATCCG -> GAAACGGGCATATATCCGC
TGAAACGGGCATCGGCGAG -> GAAACGGGCATCGGCGAGG
TGAAACGGGCATGGGAGAG -> GAAACGGGCATGGGAGAGC
TGAAACGGGCATTATGTGT -> GAAACGGGCATTATGTGTC
TGAACGACACAACTGGACT -> GAACGACACAACTGGACTT
TGAATATCACTTTTGCGGG -> GAATATCACTTTTGCGGGG
TGAATATTCGGAGAGTGCT -> GAATATTCGGAGAGTGCTT
TGAATTACGCTCGACAAAC -> GAATTACGCTCGACAAACC
TGACAAGCAAAACGTGTTG -> GACAAGCAAAACGTGTTGA
TGACAAGTGGACACTAGCC -> GACAAGTGGACACTAGCCG
TGACACCGATAGTTGACGG -> GACACCGATAGTTGACGGA
TGACAGCGACTACGGCCCA -> GACAGCGACTACGGCCCAA
TGACAGTGGTCGACGATTT -> GACAGTGGTCGACGATTTA
TGACATCTCCTGCTATGTT -> GACATCTCCTGCTATGTTC
TGACCTAACGGTTGCTTGT -> GACCTAACGGTTGCTTGTG
TGACCTAACTCTACCACTT -> GACCTAACTCTACCACTTT
TGACCTATTATAAGGCGCG -> GACCTATTATAAGGCGCGC
TGACGGAGAACAGCGTTCA -> GACGGAGAACAGCGTTCAA
TGACGTCGTCAACTTGCCT -> GACGTCGTCAACTTGCCTG
TGACTAACTCTAAATGCTA -> GACTAACTCTAAATGCTAG
TGACTATGGCTACTCTTTG -> GACTATGGCTACTCTTTGT
TGACTATTGCTTGCCTGAA -> GACTATTGCTTGCCTGAAA
TGACTGTTGGTGATAGCGA -> GACTGTTGGTGATAGCGAT
TGACTTGGAGTGCAGTCTT -> GACTTGGAGTGCAGTCTTA
TGAGACGCTGGAGGCATGC -> GAGACGCTGGAGGCATGCG
TGAGCTTGTGAATTACGCT -> GAGCTTGTGAATTACGCTC
TGAGGCAGGATTCTATCCT -> GAGGCAGGATTCTATCCTG
TGAGGCGTATGAGTCAGCT -> GAGGCGTATGAGTCAGCTC
TGAGTCAGCTCGGGCGAAA -> GAGTCAGCTCGGGCGAAAT
TGATAGACAATTTTCTTAA -> GATAGACAATTTTCTTAAT
TGATAGCGATTCTGTCGGC -> GATAGCGATTCTGTCGGCG
TGATAGCTTACGTATCCCC -> GATAGCTTACGTATCCCCT
TGATCTAGTGGACTGCGAT -> GATCTAGTGGACTGCGATC
TGATGACCTAACTCTACCA -> GATGACCTAACTCTACCAC
TGATGCAACAGAAAATCTA -> GATGCAACAGAAAATCTAG
TGATTGGATAAAAACTCAA -> GATTGGATAAAAACTCAAC
TGCAACAGAAAATCTAGAG -> GCAACAGAAAATCTAGAGT
TGCACCGCTTTGGCTCCTA -> GCACCGCTTTGGCTCCTAA
TGCACGGCATGCTCCCTAC -> GCACGGCATGCTCCCTACA
TGCACTCCTGGCCTAGTTT -> GCACTCCTGGCCTAGTTTG
TGCAGTCTTAGGAGTATAC -> GCAGTCTTAGGAGTATACT
TGCATAGAGCAGTACGACT -> GCATAGAGCAGTACGACTT
TGCATTGCCCATGAATATC -> GCATTGCCCATGAATATCA
TGCCACCATTTTGGCATGG -> GCCACCATTTTGGCATGGA
TGCCCACCGCAAAACACGC -> GCCCACCGCAAAACACGCA
TGCCCATGAATATCACTTT -> GCCCATGAATATCACTTTT
TGCCCCTGGGTGTTGCTAA -> GCCCCTGGGTGTTGCTAAA
TGCCGCCTGTCCTTCTTAA -> GCCGCCTGTCCTTCTTAAG
TGCCGTTTCATCCTGCTTC -> GCCGTTTCATCCTGCTTCC
TGCCTGAAACGGGCATATA -> GCCTGAAACGGGCATATAT
TGCCTGAAACGGGCATCGG -> GCCTGAAACGGGCATCGGC
TGCCTGAAACGGGCATGGG -> GCCTGAAACGGGCATGGGA
TGCCTGAAACGGGCATTAT -> GCCTGAAACGGGCATTATG
TGCCTGTCTCGTTTCAGCA -> GCCTGTCTCGTTTCAGCAG
TGCGACCCACGGACCGCGA -> GCGACCCACGGACCGCGAT
TGCGACGAGGAGACCCAGA -> GCGACGAGGAGACCCAGAA
TGCGAGCTTACCGTCAGTT -> GCGAGCTTACCGTCAGTTT
TGCGATCTCTCGAACGCCG -> GCGATCTCTCGAACGCCGA
TGCGCCCTCAAGAGCACCA -> GCGCCCTCAAGAGCACCAC
TGCGCGATTCCTAGTCATC -> GCGCGATTCCTAGTCATCG
TGCGCGTGCCCACCGCAAA -> GCGCGTGCCCACCGCAAAA
TGCGGCTACCGACTTCTTG -> GCGGCTACCGACTTCTTGG
TGCGGGGTCGCTCCACGCG -> GCGGGGTCGCTCCACGCGA
TGCGGTGATGACCTAACTC -> GCGGTGATGACCTAACTCT
TGCGTAGAAGTTCCCACAC -> GCGTAGAAGTTCCCACACA
TGCTAAAGGGCGAAAACCA -> GCTAAAGGGCGAAAACCAA
TGCTACCGCGGTCTAATTT -> GCTACCGCGGTCTAATTTA
TGCTAGCCGTCGAGCCCTA -> GCTAGCCGTCGAGCCCTAT
TGCTATCTTAACCCGTTCC -> GCTATCTTAACCCGTTCCA
TGCTATGTTCTCTGTGTAG -> GCTATGTTCTCTGTGTAGG
TGCTATTCTATCACGCTGT -> GCTATTCTATCACGCTGTA
TGCTCCCTACATGGTATAG -> GCTCCCTACATGGTATAGT
TGCTGAGCTTGTGAATTAC -> GCTGAGCTTGTGAATTACG
TGCTGATAGCTTACGTATC -> GCTGATAGCTTACGTATCC
TGCTTCCTCCAAACTAAAC -> GCTTCCTCCAAACTAAACT
TGCTTGACTAAGTCTCGGA -> GCTTGACTAAGTCTCGGAA
TGCTTGCCTGAAACGGGCA -> GCTTGCCTGAAACGGGCAT
TGCTTGTGTGGAATGTGTG -> GCTTGTGTGGAATGTGTGT
TGGAATGTGTGTGGCCCTA -> GGAATGTGTGTGGCCCTAC
TGGAATTCATAGCGTCAAT -> GGAATTCATAGCGTCAATT
TGGACACTAGCCGTGGGTC -> GGACACTAGCCGTGGGTCG
TGGACTGCGATCTCTCGAA -> GGACTGCGATCTCTCGAAC
TGGACTTAGGGATGACAGC -> GGACTTAGGGATGACAGCG
TGGAGCTATATGTCGTGTT -> GGAGCTATATGTCGTGTTC
TGGAGGCATGCGAGCTTAC -> GGAGGCATGCGAGCTTACC
TGGAGTGCAGTCTTAGGAG -> GGAGTGCAGTCTTAGGAGT
TGGATAAAAACTCAACTAT -> GGATAAAAACTCAACTATA
TGGATATTTAGTGCGCGTG -> GGATATTTAGTGCGCGTGC
TGGATCAACTAAGTGAGGC -> GGATCAACTAAGTGAGGCA
TGGATGATGCAACAGAAAA -> GGATGATGCAACAGAAAAT
TGGCAAGCCCGAAAGATCT -> GGCAAGCCCGAAAGATCTT
TGGCACATCTCCATTGCCA -> GGCACATCTCCATTGCCAC
TGGCATGGATGATGCAACA -> GGCATGGATGATGCAACAG
TGGCCCTACTCGAGGGGAT -> GGCCCTACTCGAGGGGATG
TGGCCTAGTTTGTTCTTGA -> GGCCTAGTTTGTTCTTGAT
TGGCGCTTACCAGCCATGA -> GGCGCTTACCAGCCATGAA
TGGCGGTTTGCATAGAGCA -> GGCGGTTTGCATAGAGCAG
TGGCTACTCTTTGTAATCA -> GGCTACTCTTTGTAATCAG
TGGCTCCTAACTCCGGTGT -> GGCTCCTAACTCCGGTGTC
TGGGACATGTACCAGTCTC -> GGGACATGTACCAGTCTCG
TGGGAGAGCGCTGTTTCTC -> GGGAGAGCGCTGTTTCTCG
TGGGATACTTATTTTGTGA -> GGGATACTTATTTTGTGAC
TGGGATATATATACATATT -> GGGATATATATACATATTC
TGGGGAAATGACACCGATA -> GGGGAAATGACACCGATAG
TGGGTAGGAACGAACCCTT -> GGGTAGGAACGAACCCTTG
TGGGTCGAGTATTCGACTC -> GGGTCGAGTATTCGACTCT
TGGGTGTTGCTAAAGGGCG -> GGGTGTTGCTAAAGGGCGA
TGGTATAGTACATATAGGT -> GGTATAGTACATATAGGTT
TGGTATCAGGGGGCAGAGG -> GGTATCAGGGGGCAGAGGC
TGGTCAAATTTAACCTCCT -> GGTCAAATTTAACCTCCTC
TGGTCATTCAACGGAAGAG -> GGTCATTCAACGGAAGAGT
TGGTCGACGATTTAATCGT -> GGTCGACGATTTAATCGTA
TGGTGATAGCGATTCTGTC -> GGTGATAGCGATTCTGTCG
TGTAACAATTCTTTAGATG -> GTAACAATTCTTTAGATGT
TGTAACTGCTATTCTATCA -> GTAACTGCTATTCTATCAC
TGTAAGAGTCGAGCGTTGA -> GTAAGAGTCGAGCGTTGAC
TGTAATCAGCACCAGTTAC -> GTAATCAGCACCAGTTACT
TGTACCAGTCTCGGATTAC -> GTACCAGTCTCGGATTACA
TGTACCGGTCCTTCTATTG -> GTACCGGTCCTTCTATTGG
TGTAGGCATTTGTTGTATA -> GTAGGCATTTGTTGTATAA
TGTATAATTGTACCGGTCC -> GTATAATTGTACCGGTCCT
TGTATCAAAACCGGAGGCG -> GTATCAAAACCGGAGGCGA
TGTCCATGTCGCCCCAGTG -> GTCCATGTCGCCCCAGTGA
TGTCCTGCCTGTCTCGTTT -> GTCCTGCCTGTCTCGTTTC
TGTCCTTCTTAAGAGCACG -> GTCCTTCTTAAGAGCACGC
TGTCGCCCCAGTGACCTAA -> GTCGCCCCAGTGACCTAAC
TGTCGGCGGTATCTGGGTA -> GTCGGCGGTATCTGGGTAG
TGTCGGTTAGCCCTTCGAT -> GTCGGTTAGCCCTTCGATC
TGTCGTGTTCTAGTGCGGT -> GTCGTGTTCTAGTGCGGTG
TGTCTAGGTTTCTCGAAAA -> GTCTAGGTTTCTCGAAAAA
TGTCTATCGGCAAATGATT -> GTCTATCGGCAAATGATTG
TGTCTCGTTTCAGCAGTCT -> GTCTCGTTTCAGCAGTCTG
TGTCTCTTCGCCGTAGTCG -> GTCTCTTCGCCGTAGTCGA
TGTGAATTACGCTCGACAA -> GTGAATTACGCTCGACAAA
TGTGACAGTGGTCGACGAT -> GTGACAGTGGTCGACGATT
TGTGCCGCCTGTCCTTCTT -> GTGCCGCCTGTCCTTCTTA
TGTGCTATCTTAACCCGTT -> GTGCTATCTTAACCCGTTC
TGTGGAATGTGTGTGGCCC -> GTGGAATGTGTGTGGCCCT
TGTGGCCCTACTCGAGGGG -> GTGGCCCTACTCGAGGGGA
TGTGGCGGTTTGCATAGAG -> GTGGCGGTTTGCATAGAGC
TGTGGTCATTCAACGGAAG -> GTGGTCATTCAACGGAAGA
TGTGTAGGCATTTGTTGTA -> GTGTAGGCATTTGTTGTAT
TGTGTCTAGGTTTCTCGAA -> GTGTCTAGGTTTCTCGAAA
TGTGTGGAATGTGTGTGGC -> GTGTGGAATGTGTGTGGCC
TGTGTGGCCCTACTCGAGG -> GTGTGGCCCTACTCGAGGG
TGTGTGTGGCCCTACTCGA -> GTGTGTGGCCCTACTCGAG
TGTTCTAGTGCGGTGATGA -> GTTCTAGTGCGGTGATGAC
TGTTCTCTGTGTAGGCATT -> GTTCTCTGTGTAGGCATTT
TGTTCTTGATCTAGTGGAC -> GTTCTTGATCTAGTGGACT
TGTTGACTATTGCTTGCCT -> GTTGACTATTGCTTGCCTG
TGTTGCTAAAGGGCGAAAA -> GTTGCTAAAGGGCGAAAAC
TGTTGGTGATAGCGATTCT -> GTTGGTGATAGCGATTCTG
TGTTGTATAATTGTACCGG -> GTTGTATAATTGTACCGGT
TGTTTCTCGAAAAATAGTC -> GTTTCTCGAAAAATAGTCA
TTAACCCGTTCCACGCGGA -> TAACCCGTTCCACGCGGAC
TTAACCTCCTCAGTTTTTT -> TAACCTCCTCAGTTTTTTC
TTAAGAGCACGCCTGGATA -> TAAGAGCACGCCTGGATAT
TTAAGGGTGGATCAACTAA -> TAAGGGTGGATCAACTAAG
TTAATCAGGGGCACCATCG -> TAATCAGGGGCACCATCGT
TTAATCGTAAAGCTTGCAC -> TAATCGTAAAGCTTGCACG
TTACATGTAACTGCTATTC -> TACATGTAACTGCTATTCT
TTACCACTTGACAAGTGGA -> TACCACTTGACAAGTGGAC
TTACCAGCCATGAACGACA -> TACCAGCCATGAACGACAC
TTACCGTCAGTTTCCCCAC -> TACCGTCAGTTTCCCCACT
TTACGCTCGACAAACCGAA -> TACGCTCGACAAACCGAAT
TTACGTATCCCCTTTGACC -> TACGTATCCCCTTTGACCT
TTACTTATGCTGAGCTTGT -> TACTTATGCTGAGCTTGTG
TTAGATGTGCCGCCTGTCC -> TAGATGTGCCGCCTGTCCT
TTAGCCCTTCGATCAATGC -> TAGCCCTTCGATCAATGCA
TTAGGAGTATACTGAATAT -> TAGGAGTATACTGAATATT
TTAGGGATGACAGCGACTA -> TAGGGATGACAGCGACTAC
TTAGTACGCAGCAATCACA -> TAGTACGCAGCAATCACAC
TTAGTGCGACCCACGGACC -> TAGTGCGACCCACGGACCG
TTAGTGCGCGTGCCCACCG -> TAGTGCGCGTGCCCACCGC
TTATAAGGCGCGCAAACAT -> TATAAGGCGCGCAAACATG
TTATATCGCTGGGATATAT -> TATATCGCTGGGATATATA
TTATGCTGAGCTTGTGAAT -> TATGCTGAGCTTGTGAATT
TTATGTGTCTAGGTTTCTC -> TATGTGTCTAGGTTTCTCG
TTATTGATAGACAATTTTC -> TATTGATAGACAATTTTCT
TTATTTTGTGACAGTGGTC -> TATTTTGTGACAGTGGTCG
TTCAAAAATACGGTTCCAC -> TCAAAAATACGGTTCCACA
TTCAAAACCTGCGTAGAAG -> TCAAAACCTGCGTAGAAGT
TTCAACGGAAGAGTCATCG -> TCAACGGAAGAGTCATCGT
TTCACAGTTGCGCCCTCAA -> TCACAGTTGCGCCCTCAAG
TTCAGCAGTCTGCGGCTAC -> TCAGCAGTCTGCGGCTACC
TTCATAGCGTCAATTTCGC -> TCATAGCGTCAATTTCGCA
TTCATCCTGCTTCCTCCAA -> TCATCCTGCTTCCTCCAAA
TTCCAATCAATGTGCTATC -> TCCAATCAATGTGCTATCT
TTCCACATAATACTTCACA -> TCCACATAATACTTCACAG
TTCCACGCGGACCTTGTCC -> TCCACGCGGACCTTGTCCA
TTCCCACACAGCCAAAGCA -> TCCCACACAGCCAAAGCAC
TTCCCCACTATGGCAAGCC -> TCCCCACTATGGCAAGCCC
TTCCTAGTCATCGCTCTGC -> TCCTAGTCATCGCTCTGCT
TTCCTCCAAACTAAACTTT -> TCCTCCAAACTAAACTTTA
TTCCTTTGGCGCTTACCAG -> TCCTTTGGCGCTTACCAGC
TTCGACTCTGACTAACTCT -> TCGACTCTGACTAACTCTA
TTCGATCAATGCACCGCTT -> TCGATCAATGCACCGCTTT
TTCGCACAATCAGCTACTA -> TCGCACAATCAGCTACTAT
TTCGCCACACCTATATCAT -> TCGCCACACCTATATCATG
TTCGCCGTAGTCGATCGCT -> TCGCCGTAGTCGATCGCTG
TTCGGAACCCCGCGGGGGT -> TCGGAACCCCGCGGGGGTC
TTCGGAGAGTGCTTGACTA -> TCGGAGAGTGCTTGACTAA
TTCGGCGACTTTTGTAACA -> TCGGCGACTTTTGTAACAA
TTCGGCGATTGACTTGGAG -> TCGGCGATTGACTTGGAGT
TTCGTTTCTCGAAAAATAG -> TCGTTTCTCGAAAAATAGT
TTCTAGTGCGGTGATGACC -> TCTAGTGCGGTGATGACCT
TTCTATCACGCTGTAAGAG -> TCTATCACGCTGTAAGAGT
TTCTATCCTGGCACATCTC -> TCTATCCTGGCACATCTCC
TTCTATTGGGACATGTACC -> TCTATTGGGACATGTACCA
TTCTCGAAAAATAGTCAAT -> TCTCGAAAAATAGTCAATG
TTCTCGAAAAATAGTCACC -> TCTCGAAAAATAGTCACCT
TTCTCGAAAAATAGTCACT -> TCTCGAAAAATAGTCACTT
TTCTCGAAAAATAGTCAGG -> TCTCGAAAAATAGTCAGGC
TTCTCTATTAGTGCGACCC -> TCTCTATTAGTGCGACCCA
TTCTCTGTGTAGGCATTTG -> TCTCTGTGTAGGCATTTGT
TTCTGTCGGCGGTATCTGG -> TCTGTCGGCGGTATCTGGG
TTCTTAAGAGCACGCCTGG -> TCTTAAGAGCACGCCTGGA
TTCTTAATCAGGGGCACCA -> TCTTAATCAGGGGCACCAT
TTCTTGATCTAGTGGACTG -> TCTTGATCTAGTGGACTGC
TTCTTGCCTGAAACGGGCA -> TCTTGCCTGAAACGGGCAT
TTCTTGGGATACTTATTTT -> TCTTGGGATACTTATTTTG
TTCTTTAGATGTGCCGCCT -> TCTTTAGATGTGCCGCCTG
TTGACAAGCAAAACGTGTT -> TGACAAGCAAAACGTGTTG
TTGACAAGTGGACACTAGC -> TGACAAGTGGACACTAGCC
TTGACCTATTATAAGGCGC -> TGACCTATTATAAGGCGCG
TTGACGGAGAACAGCGTTC -> TGACGGAGAACAGCGTTCA
TTGACTATGGCTACTCTTT -> TGACTATGGCTACTCTTTG
TTGACTATTGCTTGCCTGA -> TGACTATTGCTTGCCTGAA
TTGACTGTTGGTGATAGCG -> TGACTGTTGGTGATAGCGA
TTGACTTGGAGTGCAGTCT -> TGACTTGGAGTGCAGTCTT
TTGATAGACAATTTTCTTA -> TGATAGACAATTTTCTTAA
TTGATCTAGTGGACTGCGA -> TGATCTAGTGGACTGCGAT
TTGCACGGCATGCTCCCTA -> TGCACGGCATGCTCCCTAC
TTGCACTCCTGGCCTAGTT -> TGCACTCCTGGCCTAGTTT
TTGCATAGAGCAGTACGAC -> TGCATAGAGCAGTACGACT
TTGCATTGCCCATGAATAT -> TGCATTGCCCATGAATATC
TTGCCACCATTTTGGCATG -> TGCCACCATTTTGGCATGG
TTGCCCATGAATATCACTT -> TGCCCATGAATATCACTTT
TTGCCTGAAACGGGCATAT -> TGCCTGAAACGGGCATATA
TTGCCTGAAACGGGCATCG -> TGCCTGAAACGGGCATCGG
TTGCCTGAAACGGGCATGG -> TGCCTGAAACGGGCATGGG
TTGCCTGAAACGGGCATTA -> TGCCTGAAACGGGCATTAT
TTGCGCCCTCAAGAGCACC -> TGCGCCCTCAAGAGCACCA
TTGCGCGATTCCTAGTCAT -> TGCGCGATTCCTAGTCATC
TTGCGGGGTCGCTCCACGC -> TGCGGGGTCGCTCCACGCG
TTGCTAAAGGGCGAAAACC -> TGCTAAAGGGCGAAAACCA
TTGCTACCGCGGTCTAATT -> TGCTACCGCGGTCTAATTT
TTGCTTGCCTGAAACGGGC -> TGCTTGCCTGAAACGGGCA
TTGCTTGTGTGGAATGTGT -> TGCTTGTGTGGAATGTGTG
TTGGAGTGCAGTCTTAGGA -> TGGAGTGCAGTCTTAGGAG
TTGGATAAAAACTCAACTA -> TGGATAAAAACTCAACTAT
TTGGCATGGATGATGCAAC -> TGGCATGGATGATGCAACA
TTGGCGCTTACCAGCCATG -> TGGCGCTTACCAGCCATGA
TTGGCTCCTAACTCCGGTG -> TGGCTCCTAACTCCGGTGT
TTGGGACATGTACCAGTCT -> TGGGACATGTACCAGTCTC
TTGGGATACTTATTTTGTG -> TGGGATACTTATTTTGTGA
TTGGGGAAATGACACCGAT -> TGGGGAAATGACACCGATA
TTGGTATCAGGGGGCAGAG -> TGGTATCAGGGGGCAGAGG
TTGGTGATAGCGATTCTGT -> TGGTGATAGCGATTCTGTC
TTGTAACAATTCTTTAGAT -> TGTAACAATTCTTTAGATG
TTGTAATCAGCACCAGTTA -> TGTAATCAGCACCAGTTAC
TTGTACCGGTCCTTCTATT -> TGTACCGGTCCTTCTATTG
TTGTATAATTGTACCGGTC -> TGTATAATTGTACCGGTCC
TTGTATCAAAACCGGAGGC -> TGTATCAAAACCGGAGGCG
TTGTCCATGTCGCCCCAGT -> TGTCCATGTCGCCCCAGTG
TTGTCTATCGGCAAATGAT -> TGTCTATCGGCAAATGATT
TTGTGAATTACGCTCGACA -> TGTGAATTACGCTCGACAA
TTGTGACAGTGGTCGACGA -> TGTGACAGTGGTCGACGAT
TTGTGTGGAATGTGTGTGG -> TGTGTGGAATGTGTGTGGC
TTGTTCTTGATCTAGTGGA -> TGTTCTTGATCTAGTGGAC
TTGTTGTATAATTGTACCG -> TGTTGTATAATTGTACCGG
TTTAACCTCCTCAGTTTTT -> TTAACCTCCTCAGTTTTTT
TTTAATCGTAAAGCTTGCA -> TTAATCGTAAAGCTTGCAC
TTTAGATGTGCCGCCTGTC -> TTAGATGTGCCGCCTGTCC
TTTAGTACGCAGCAATCAC -> TTAGTACGCAGCAATCACA
TTTAGTGCGCGTGCCCACC -> TTAGTGCGCGTGCCCACCG
TTTATTGATAGACAATTTT -> TTATTGATAGACAATTTTC
TTTCAGCAGTCTGCGGCTA -> TTCAGCAGTCTGCGGCTAC
TTTCATCCTGCTTCCTCCA -> TTCATCCTGCTTCCTCCAA
TTTCCCCACTATGGCAAGC -> TTCCCCACTATGGCAAGCC
TTTCGCACAATCAGCTACT -> TTCGCACAATCAGCTACTA
TTTCGGCGACTTTTGTAAC -> TTCGGCGACTTTTGTAACA
TTTCTCGAAAAATAGTCAA -> TTCTCGAAAAATAGTCAAT
TTTCTCGAAAAATAGTCAC -> TTCTCGAAAAATAGTCACC,TTCTCGAAAAATAGTCACT
TTTCTCGAAAAATAGTCAG -> TTCTCGAAAAATAGTCAGG
TTTCTTAATCAGGGGCACC -> TTCTTAATCAGGGGCACCA
TTTGACCTATTATAAGGCG -> TTGACCTATTATAAGGCGC
TTTGCATAGAGCAGTACGA -> TTGCATAGAGCAGTACGAC
TTTGCGGGGTCGCTCCACG -> TTGCGGGGTCGCTCCACGC
TTTGGCATGGATGATGCAA -> TTGGCATGGATGATGCAAC
TTTGGCGCTTACCAGCCAT -> TTGGCGCTTACCAGCCATG
TTTGGCTCCTAACTCCGGT -> TTGGCTCCTAACTCCGGTG
TTTGGGGAAATGACACCGA -> TTGGGGAAATGACACCGAT
TTTGTAACAATTCTTTAGA -> TTGTAACAATTCTTTAGAT
TTTGTAATCAGCACCAGTT -> TTGTAATCAGCACCAGTTA
TTTGTGACAGTGGTCGACG -> TTGTGACAGTGGTCGACGA
TTTGTTCTTGATCTAGTGG -> TTGTTCTTGATCTAGTGGA
TTTGTTGTATAATTGTACC -> TTGTTGTATAATTGTACCG
TTTTCGGCGACTTTTGTAA -> TTTCGGCGACTTTTGTAAC
TTTTCTTAATCAGGGGCAC -> TTTCTTAATCAGGGGCACC
TTTTGCGGGGTCGCTCCAC -> TTTGCGGGGTCGCTCCACG
TTTTGGCATGGATGATGCA -> TTTGGCATGGATGATGCAA
TTTTGGGGAAATGACACCG -> TTTGGGGAAATGACACCGA
TTTTGTAACAATTCTTTAG -> TTTGTAACAATTCTTTAGA
TTTTGTGACAGTGGTCGAC -> TTTGTGACAGTGGTCGACG
TTTTTCGGCGACTTTTGTA -> TTTTCGGCGACTTTTGTAA
TTTTTTCGGCGACTTTTGT -> TTTTTCGGCGACTTTTGTA
