AAAAAAAACTA -> AAAAAAACTAG
AAAAAAACTAG -> AAAAAACTAGC
AAAAAACTAGC -> AAAAACTAGCA
AAAAAAGAAGG -> AAAAAGAAGGT
AAAAACTAGCA -> AAAACTAGCAA
AAAAAGAAGGT -> AAAAGAAGGTG
AAAACTAGCAA -> AAACTAGCAAA
AAAACTATCTT -> AAACTATCTTG
AAAACTCGTTC -> AAACTCGTTCC
AAAAGAAGGTG -> AAAGAAGGTGA
AAAAGCATGGA -> AAAGCATGGAA
AAAATGCGACA -> AAATGCGACAC
AAACAGTGTTT -> AACAGTGTTTC
AAACAGTTGGG -> AACAGTTGGGA
AAACGCAGTAC -> AACGCAGTACT
AAACTAGCAAA -> AACTAGCAAAT
AAACTATCTTG -> AACTATCTTGA
AAACTCGTTCC -> AACTCGTTCCC
AAACTGTGGGA -> AACTGTGGGAA
AAACTTGAATT -> AACTTGAATTT
AAACTTTTCAC -> AACTTTTCACG
AAAGAAGGTGA -> AAGAAGGTGAC
AAAGCATGGAA -> AAGCATGGAAT
AAAGCCCCCAG -> AAGCCCCCAGC
AAAGCGAACAC -> AAGCGAACACC
AAAGCTTCTTA -> AAGCTTCTTAA
AAATAAGCTCA -> AATAAGCTCAC
AAATCAGGTGT -> AATCAGGTGTA
AAATCGAGCTC -> AATCGAGCTCT
AAATGCGACAC -> AATGCGACACA
AAATGCTACGT -> AATGCTACGTC
AAATGTGTGCA -> AATGTGTGCAT
AAATGTTCTAA -> AATGTTCTAAC
AAATTGCATAT -> AATTGCATATC
AACAAGGCCGG -> ACAAGGCCGGC
AACAAGTGGTA -> ACAAGTGGTAC
AACACCTAATA -> ACACCTAATAC
AACAGTGTTTC -> ACAGTGTTTCA
AACAGTTGGGA -> ACAGTTGGGAC
AACCACGAGCT -> ACCACGAGCTT
AACCAGATTGC -> ACCAGATTGCG
AACCATCTTGG -> ACCATCTTGGT
AACCCATTATC -> ACCCATTATCA
AACCGTCAAGC -> ACCGTCAAGCA
AACGACTTGTT -> ACGACTTGTTT
AACGAGCCCTA -> ACGAGCCCTAA
AACGAGTGCGT -> ACGAGTGCGTC
AACGCAGTACT -> ACGCAGTACTA
AACGCTGATTT -> ACGCTGATTTG
AACGGGAACGG -> ACGGGAACGGT
AACGGTGGGAT -> ACGGTGGGATG
AACGTCTATCC -> ACGTCTATCCT
AACGTCTGAGG -> ACGTCTGAGGA
AACTACAGTTC -> ACTACAGTTCT
AACTAGCAAAT -> ACTAGCAAATC
AACTATCTTGA -> ACTATCTTGAG
AACTATTATGC -> ACTATTATGCG
AACTCACGCAT -> ACTCACGCATG
AACTCACGTTG -> ACTCACGTTGA
AACTCGTTCCC -> ACTCGTTCCCC
AACTGTAGGGC -> ACTGTAGGGCC
AACTGTGGGAA -> ACTGTGGGAAT
AACTTGAATTT -> ACTTGAATTTC
AACTTTTCACG -> ACTTTTCACGC
AAGAAGCGAGT -> AGAAGCGAGTC
AAGAAGGTGAC -> AGAAGGTGACG
AAGACGAAGTC -> AGACGAAGTCC
AAGATAGGGTT -> AGATAGGGTTC
AAGATGATCGT -> AGATGATCGTT
AAGATTTTATA -> AGATTTTATAC
AAGCACCCGGC -> AGCACCCGGCG
AAGCATGGAAT -> AGCATGGAATA
AAGCCCCCAGC -> AGCCCCCAGCG
AAGCCCGAAGA -> AGCCCGAAGAT
AAGCCCGGGCC -> AGCCCGGGCCT
AAGCGAACACC -> AGCGAACACCT
AAGCGAGTCGC -> AGCGAGTCGCG
AAGCTCACACT -> AGCTCACACTA
AAGCTGAATCA -> AGCTGAATCAG
AAGCTTCTTAA -> AGCTTCTTAAA
AAGGAACGAGT -> AGGAACGAGTG
AAGGCCGAGCT -> AGGCCGAGCTG
AAGGCCGGCTA -> AGGCCGGCTAA
AAGGGACCTTC -> AGGGACCTTCG
AAGGGCGAATT -> AGGGCGAATTG
AAGGTGGTCGA -> AGGTGGTCGAC
AAGTACGCCTC -> AGTACGCCTCA
AAGTCCGGGGC -> AGTCCGGGGCC
AAGTCGTTGTC -> AGTCGTTGTCT
AAGTCTTAAAC -> AGTCTTAAACG
AAGTGGTACGC -> AGTGGTACGCC
AAGTTGACGTG -> AGTTGACGTGG
AATAACAAGTG -> ATAACAAGTGG
AATAAGCTCAC -> ATAAGCTCACA
AATAAGGGACC -> ATAAGGGACCT
AATACAAAGCT -> ATACAAAGCTT
AATACGAGTAG -> ATACGAGTAGA
AATACGCTCAG -> ATACGCTCAGC
AATACGTTAGC -> ATACGTTAGCT
AATATGGGACC -> ATATGGGACCA
AATCACCGCCC -> ATCACCGCCCA
AATCACTGTTA -> ATCACTGTTAC
AATCAGCGCCC -> ATCAGCGCCCC
AATCAGGTGTA -> ATCAGGTGTAT
AATCGAGCTCT -> ATCGAGCTCTT
AATCGCGCGAG -> ATCGCGCGAGC
AATCGGAAGCC -> ATCGGAAGCCC
AATCGGACACT -> ATCGGACACTT
AATGCGACACA -> ATGCGACACAG
AATGCTACGTC -> ATGCTACGTCT
AATGGGTTGAA -> ATGGGTTGAAA
AATGTCAACCA -> ATGTCAACCAT
AATGTCCAGTT -> ATGTCCAGTTC
AATGTGTGCAT -> ATGTGTGCATC
AATGTTCTAAC -> ATGTTCTAACA
AATTAGAGCTA -> ATTAGAGCTAA
AATTGAACTGT -> ATTGAACTGTA
AATTGCATATC -> ATTGCATATCA
AATTTCTGGAA -> ATTTCTGGAAT
ACAAACTTGAA -> CAAACTTGAAT
ACAAAGCTTCT -> CAAAGCTTCTT
ACAACGAGCCC -> CAACGAGCCCT
ACAAGGCCGGC -> CAAGGCCGGCT
ACAAGTGGTAC -> CAAGTGGTACG
ACAATACGTTA -> CAATACGTTAG
ACAATCGGAAG -> CAATCGGAAGC
ACAATGTCCAG -> CAATGTCCAGT
ACACAGCCACT -> CACAGCCACTC
ACACAGTGGAG -> CACAGTGGAGG
ACACCCGCAGT -> CACCCGCAGTA
ACACCTAATAC -> CACCTAATACG
ACACCTTTGCT -> CACCTTTGCTC
ACACGCTAGTC -> CACGCTAGTCG
ACACTATGTAG -> CACTATGTAGA
ACACTTCGAAA -> CACTTCGAAAA
ACAGATATCTC -> CAGATATCTCG
ACAGATGTGCT -> CAGATGTGCTA
ACAGCCACTCT -> CAGCCACTCTA
ACAGGGCCATT -> CAGGGCCATTC
ACAGTATCGGA -> CAGTATCGGAT
ACAGTGGAGGT -> CAGTGGAGGTA
ACAGTGTTTCA -> CAGTGTTTCAT
ACAGTTCTATG -> CAGTTCTATGT
ACAGTTGCAGC -> CAGTTGCAGCT
ACAGTTGGGAC -> CAGTTGGGACT
ACATACTCGAA -> CATACTCGAAC
ACATGCAGCAA -> CATGCAGCAAT
ACATGGATGCA -> CATGGATGCAC
ACATGTGGAGG -> CATGTGGAGGT
ACCAAAGCCCC -> CCAAAGCCCCC
ACCACAGATAT -> CCACAGATATC
ACCACGAGCTT -> CCACGAGCTTG
ACCACTTGTCT -> CCACTTGTCTC
ACCAGATTGCG -> CCAGATTGCGT
ACCATAGCGTT -> CCATAGCGTTG
ACCATCTGATA -> CCATCTGATAG
ACCATCTTGGT -> CCATCTTGGTT
ACCCAACGGGA -> CCCAACGGGAA
ACCCATTATCA -> CCCATTATCAC
ACCCATTTATA -> CCCATTTATAG
ACCCCAACGTC -> CCCCAACGTCT
ACCCCGGTATT -> CCCCGGTATTT
ACCCGCAGTAG -> CCCGCAGTAGA
ACCCGCTATCG -> CCCGCTATCGG
ACCCGGCGAAA -> CCCGGCGAAAG
ACCGAGATTGG -> CCGAGATTGGT
ACCGCCCAAGA -> CCGCCCAAGAA
ACCGTCAAGCA -> CCGTCAAGCAC
ACCTAATACGA -> CCTAATACGAG
ACCTACAGGGC -> CCTACAGGGCC
ACCTATCGAGG -> CCTATCGAGGG
ACCTTCGCGCT -> CCTTCGCGCTT
ACCTTTGCTCC -> CCTTTGCTCCT
ACGAAGTCCGG -> CGAAGTCCGGG
ACGACGGCGAG -> CGACGGCGAGG
ACGACTTGTTT -> CGACTTGTTTG
ACGAGAGCATA -> CGAGAGCATAG
ACGAGCCCTAA -> CGAGCCCTAAG
ACGAGCTTGTT -> CGAGCTTGTTC
ACGAGTAAGAT -> CGAGTAAGATT
ACGAGTAGAAT -> CGAGTAGAATG
ACGAGTGCGTC -> CGAGTGCGTCA
ACGATCCAAGT -> CGATCCAAGTC
ACGATGACTTA -> CGATGACTTAA
ACGATTCAGCC -> CGATTCAGCCC
ACGCAGTACTA -> CGCAGTACTAC
ACGCATGATCA -> CGCATGATCAG
ACGCCATCTCA -> CGCCATCTCAC
ACGCCCATTCC -> CGCCCATTCCG
ACGCCTCAATC -> CGCCTCAATCG
ACGCCTTAATA -> CGCCTTAATAA
ACGCGTACAAT -> CGCGTACAATA
ACGCTACGTTT -> CGCTACGTTTC
ACGCTAGTCGC -> CGCTAGTCGCG
ACGCTCAGCTG -> CGCTCAGCTGA
ACGCTGATTTG -> CGCTGATTTGA
ACGGCGAGGTG -> CGGCGAGGTGG
ACGGGAACGGT -> CGGGAACGGTG
ACGGTCGTCTT -> CGGTCGTCTTG
ACGGTGGGATG -> CGGTGGGATGA
ACGTCTATCCT -> CGTCTATCCTT
ACGTCTGAGGA -> CGTCTGAGGAG
ACGTCTTATAC -> CGTCTTATACA
ACGTGCGAGGG -> CGTGCGAGGGC
ACGTGGTCTTC -> CGTGGTCTTCC
ACGTTAGCTAC -> CGTTAGCTACT
ACGTTGACGAC -> CGTTGACGACG
ACGTTGAGAAC -> CGTTGAGAACT
ACGTTTCGACT -> CGTTTCGACTC
ACTAATTAGAG -> CTAATTAGAGC
ACTACAGTTCT -> CTACAGTTCTA
ACTACGAGAGC -> CTACGAGAGCA
ACTAGATAGAA -> CTAGATAGAAG
ACTAGCAAATC -> CTAGCAAATCG
ACTATCTTGAG -> CTATCTTGAGC
ACTATGTAGAC -> CTATGTAGACT
ACTATGTTAGG -> CTATGTTAGGT
ACTATTATGCG -> CTATTATGCGG
ACTCACACCCG -> CTCACACCCGC
ACTCACGCATG -> CTCACGCATGA
ACTCACGTTGA -> CTCACGTTGAC
ACTCCCCAGGA -> CTCCCCAGGAG
ACTCGAACCCA -> CTCGAACCCAT
ACTCGTTCCCC -> CTCGTTCCCCC
ACTCTATACCC -> CTCTATACCCC
ACTCTCATGAC -> CTCTCATGACC
ACTGTAAATAA -> CTGTAAATAAG
ACTGTAGGGCC -> CTGTAGGGCCT
ACTGTGCATCA -> CTGTGCATCAG
ACTGTGGGAAT -> CTGTGGGAATA
ACTGTTACCAT -> CTGTTACCATC
ACTGTTGCGAG -> CTGTTGCGAGG
ACTTAAGGCCG -> CTTAAGGCCGA
ACTTACCGAGA -> CTTACCGAGAT
ACTTCGAAAAC -> CTTCGAAAACT
ACTTGAATTTC -> CTTGAATTTCT
ACTTGAGAGTA -> CTTGAGAGTAT
ACTTGTCTCAG -> CTTGTCTCAGC
ACTTGTTTGAG -> CTTGTTTGAGC
ACTTTAAGACG -> CTTTAAGACGA
ACTTTTCACGC -> CTTTTCACGCC
AGAAATGCTAC -> GAAATGCTACG
AGAAATGTTCT -> GAAATGTTCTA
AGAACCGTCAA -> GAACCGTCAAG
AGAACGCTGAT -> GAACGCTGATT
AGAACTACAGT -> GAACTACAGTT
AGAACTCACGC -> GAACTCACGCA
AGAAGCCCGGG -> GAAGCCCGGGC
AGAAGCGAGTC -> GAAGCGAGTCG
AGAAGTACGCC -> GAAGTACGCCT
AGAAGTCGTTG -> GAAGTCGTTGT
AGAATGGGTTG -> GAATGGGTTGA
AGAATGTCAAC -> GAATGTCAACC
AGACACCTTTG -> GACACCTTTGC
AGACGAAGTCC -> GACGAAGTCCG
AGACGATCCAA -> GACGATCCAAG
AGACGCTACGT -> GACGCTACGTT
AGACTCCCCAG -> GACTCCCCAGG
AGACTTTAAGA -> GACTTTAAGAC
AGAGCATAGCT -> GAGCATAGCTT
AGAGCCGCGTC -> GAGCCGCGTCA
AGAGCGCCTCT -> GAGCGCCTCTT
AGAGCTAAAAA -> GAGCTAAAAAA
AGAGTATAGAA -> GAGTATAGAAC
AGAGTGCTTTT -> GAGTGCTTTTG
AGATAAAATGC -> GATAAAATGCG
AGATAGAAGTC -> GATAGAAGTCG
AGATAGGGTTC -> GATAGGGTTCC
AGATATCTCGC -> GATATCTCGCA
AGATCCTTGGC -> GATCCTTGGCA
AGATGATCGTT -> GATGATCGTTT
AGATGTGCTAC -> GATGTGCTACA
AGATTGCGTAT -> GATTGCGTATA
AGATTGGTAAC -> GATTGGTAACT
AGATTTTATAC -> GATTTTATACC
AGCAAATCGAG -> GCAAATCGAGC
AGCAATCACCG -> GCAATCACCGC
AGCACCCGGCG -> GCACCCGGCGA
AGCAGCGACAT -> GCAGCGACATG
AGCATAGCTTC -> GCATAGCTTCG
AGCATCGGTTA -> GCATCGGTTAA
AGCATGGAATA -> GCATGGAATAT
AGCCACTCTAT -> GCCACTCTATA
AGCCAGGTCCG -> GCCAGGTCCGT
AGCCCCCAGCG -> GCCCCCAGCGC
AGCCCCCGGGG -> GCCCCCGGGGC
AGCCCGAAGAT -> GCCCGAAGATA
AGCCCGGGCCT -> GCCCGGGCCTG
AGCCCTAAGGT -> GCCCTAAGGTG
AGCCGATTTAG -> GCCGATTTAGG
AGCCGCGTCAG -> GCCGCGTCAGA
AGCGAACACCT -> GCGAACACCTA
AGCGACATGTG -> GCGACATGTGG
AGCGAGAGTGC -> GCGAGAGTGCT
AGCGAGTCGCG -> GCGAGTCGCGA
AGCGCCCCTTA -> GCGCCCCTTAT
AGCGCCTCTTT -> GCGCCTCTTTG
AGCGCGGAGCC -> GCGCGGAGCCG
AGCGTTGAGAC -> GCGTTGAGACT
AGCTAAAAAAG -> GCTAAAAAAGA
AGCTACACGCT -> GCTACACGCTA
AGCTACGGTCG -> GCTACGGTCGT
AGCTACTTGAG -> GCTACTTGAGA
AGCTCACAAAC -> GCTCACAAACT
AGCTCACACTA -> GCTCACACTAT
AGCTCGCCTTT -> GCTCGCCTTTA
AGCTCTTTCTT -> GCTCTTTCTTC
AGCTGAAACAG -> GCTGAAACAGT
AGCTGAATCAG -> GCTGAATCAGC
AGCTGAGTGAT -> GCTGAGTGATT
AGCTGTCTTAC -> GCTGTCTTACT
AGCTTACGTTG -> GCTTACGTTGA
AGCTTCGGTGT -> GCTTCGGTGTG
AGCTTCTTAAA -> GCTTCTTAAAT
AGCTTGTTCAT -> GCTTGTTCATG
AGGAAATGTGT -> GGAAATGTGTG
AGGAACGAGTG -> GGAACGAGTGC
AGGAGGCTAAA -> GGAGGCTAAAA
AGGAGGTCGGA -> GGAGGTCGGAG
AGGATACTGTT -> GGATACTGTTG
AGGCCGAGCTG -> GGCCGAGCTGA
AGGCCGGCTAA -> GGCCGGCTAAA
AGGCTAAAAGC -> GGCTAAAAGCA
AGGGACCCGCT -> GGGACCCGCTA
AGGGACCTTCG -> GGGACCTTCGC
AGGGCAGCTAC -> GGGCAGCTACA
AGGGCCATTCA -> GGGCCATTCAT
AGGGCCTTGAT -> GGGCCTTGATT
AGGGCGAATTG -> GGGCGAATTGA
AGGGCGATTAC -> GGGCGATTACC
AGGGCGCATGC -> GGGCGCATGCA
AGGGGAGAAGT -> GGGGAGAAGTA
AGGGGCTCTCG -> GGGGCTCTCGT
AGGGGTCGTAG -> GGGGTCGTAGG
AGGGTCCCCTA -> GGGTCCCCTAT
AGGGTTATGGC -> GGGTTATGGCC
AGGGTTCCCGT -> GGGTTCCCGTT
AGGTAAACTTT -> GGTAAACTTTT
AGGTACGCGTA -> GGTACGCGTAC
AGGTCATGAGT -> GGTCATGAGTA
AGGTCCGTGAG -> GGTCCGTGAGA
AGGTCGGAGAT -> GGTCGGAGATC
AGGTGGAAGTT -> GGTGGAAGTTG
AGGTGGAGGTT -> GGTGGAGGTTT
AGGTGGTCGAC -> GGTGGTCGACG
AGGTGTATCCT -> GGTGTATCCTC
AGGTTTTTATC -> GGTTTTTATCA
AGGTTTTTGCT -> GGTTTTTGCTG
AGTAAGATTTT -> GTAAGATTTTA
AGTACCATAGC -> GTACCATAGCG
AGTACGCCTCA -> GTACGCCTCAA
AGTACTACGAG -> GTACTACGAGA
AGTACTGTGCA -> GTACTGTGCAT
AGTAGAAATGT -> GTAGAAATGTT
AGTAGAATGGG -> GTAGAATGGGT
AGTATAGAACG -> GTATAGAACGC
AGTATCGGATC -> GTATCGGATCT
AGTATGCCGGC -> GTATGCCGGCG
AGTCCGGGGCC -> GTCCGGGGCCT
AGTCGCGACAT -> GTCGCGACATA
AGTCGCGATGC -> GTCGCGATGCT
AGTCGTTGTCT -> GTCGTTGTCTT
AGTCTTAAACG -> GTCTTAAACGC
AGTGATTTTGC -> GTGATTTTGCC
AGTGCGTCAGG -> GTGCGTCAGGG
AGTGCTTTTGC -> GTGCTTTTGCG
AGTGGAGGTAC -> GTGGAGGTACG
AGTGGCTAGAG -> GTGGCTAGAGC
AGTGGTACGCC -> GTGGTACGCCA
AGTGTCAGAGC -> GTGTCAGAGCC
AGTGTTTCATA -> GTGTTTCATAC
AGTTAATCGCG -> GTTAATCGCGC
AGTTCGCAGAA -> GTTCGCAGAAC
AGTTCTATGTG -> GTTCTATGTGG
AGTTGACGTGG -> GTTGACGTGGT
AGTTGCAGCTC -> GTTGCAGCTCA
AGTTGGGACTA -> GTTGGGACTAT
ATAAAATGCGA -> TAAAATGCGAC
ATAAACAGTTG -> TAAACAGTTGG
ATAACAAGTGG -> TAACAAGTGGT
ATAAGATGATC -> TAAGATGATCG
ATAAGCTCACA -> TAAGCTCACAC
ATAAGGGACCT -> TAAGGGACCTT
ATAATCACTGT -> TAATCACTGTT
ATACAAAGCTT -> TACAAAGCTTC
ATACAGTATCG -> TACAGTATCGG
ATACATGCAGC -> TACATGCAGCA
ATACCCCAACG -> TACCCCAACGT
ATACCTATCGA -> TACCTATCGAG
ATACGAGTAGA -> TACGAGTAGAA
ATACGCTCAGC -> TACGCTCAGCT
ATACGTGCGAG -> TACGTGCGAGG
ATACGTTAGCT -> TACGTTAGCTA
ATACTCGAACC -> TACTCGAACCC
ATACTGTAAAT -> TACTGTAAATA
ATACTGTTGCG -> TACTGTTGCGA
ATAGAAATGCT -> TAGAAATGCTA
ATAGAACGCTG -> TAGAACGCTGA
ATAGAAGTCGT -> TAGAAGTCGTT
ATAGCGTTGAG -> TAGCGTTGAGA
ATAGCTTCGGT -> TAGCTTCGGTG
ATAGGATACTG -> TAGGATACTGT
ATAGGGGAGAA -> TAGGGGAGAAG
ATAGGGGTCGT -> TAGGGGTCGTA
ATAGGGTTCCC -> TAGGGTTCCCG
ATAGTGGCTAG -> TAGTGGCTAGA
ATATATATTAT -> TATATATTATA
ATATATTATAA -> TATATTATAAG
ATATCACACAG -> TATCACACAGT
ATATCTCGCAG -> TATCTCGCAGT
ATATGGGACCA -> TATGGGACCAA
ATATTATAAGA -> TATTATAAGAT
ATCACAATCGG -> TCACAATCGGA
ATCACACAGTG -> TCACACAGTGG
ATCACAGTTGC -> TCACAGTTGCA
ATCACATGGAT -> TCACATGGATG
ATCACCGCCCA -> TCACCGCCCAA
ATCACTGTTAC -> TCACTGTTACC
ATCAGACGATC -> TCAGACGATCC
ATCAGCAGCGA -> TCAGCAGCGAC
ATCAGCGCCCC -> TCAGCGCCCCT
ATCAGGTGTAT -> TCAGGTGTATC
ATCCAACGTCT -> TCCAACGTCTA
ATCCAAGTCTT -> TCCAAGTCTTA
ATCCAGCCAGG -> TCCAGCCAGGT
ATCCATTAAAT -> TCCATTAAATC
ATCCTCTGCAT -> TCCTCTGCATG
ATCCTTGCCCT -> TCCTTGCCCTC
ATCCTTGGCAA -> TCCTTGGCAAC
ATCGAGCTCTT -> TCGAGCTCTTT
ATCGAGGGTCC -> TCGAGGGTCCC
ATCGCGCGAGC -> TCGCGCGAGCA
ATCGGAAGCCC -> TCGGAAGCCCG
ATCGGACACTT -> TCGGACACTTC
ATCGGATCTCG -> TCGGATCTCGT
ATCGGTGTTTA -> TCGGTGTTTAT
ATCGGTTAATA -> TCGGTTAATAC
ATCGTTGTCCC -> TCGTTGTCCCC
ATCGTTTGGCC -> TCGTTTGGCCG
ATCTCACTAGA -> TCTCACTAGAT
ATCTCGCAGTA -> TCTCGCAGTAC
ATCTCGTTCCC -> TCTCGTTCCCA
ATCTCTAAGCT -> TCTCTAAGCTG
ATCTGATAGGG -> TCTGATAGGGG
ATCTTGAGCTG -> TCTTGAGCTGT
ATCTTGGTTTT -> TCTTGGTTTTT
ATGAACGACTT -> TGAACGACTTG
ATGACCACAGA -> TGACCACAGAT
ATGACTTAAGG -> TGACTTAAGGC
ATGAGTATGCC -> TGAGTATGCCG
ATGATCAGACG -> TGATCAGACGA
ATGATCGTTTG -> TGATCGTTTGG
ATGCACGCCCA -> TGCACGCCCAT
ATGCAGCAATC -> TGCAGCAATCA
ATGCAGGGCGA -> TGCAGGGCGAT
ATGCCGGCGAA -> TGCCGGCGAAA
ATGCGACACAG -> TGCGACACAGC
ATGCGGAAGGG -> TGCGGAAGGGC
ATGCGGATACG -> TGCGGATACGT
ATGCGGGTATG -> TGCGGGTATGT
ATGCTACGTCT -> TGCTACGTCTT
ATGCTTTCTTT -> TGCTTTCTTTT
ATGGAATATGG -> TGGAATATGGG
ATGGATGCACG -> TGGATGCACGC
ATGGATTCTAT -> TGGATTCTATA
ATGGCCCATAG -> TGGCCCATAGG
ATGGGACCAAA -> TGGGACCAAAG
ATGGGTGGCAG -> TGGGTGGCAGG
ATGGGTTGAAA -> TGGGTTGAAAC
ATGTAGACTCC -> TGTAGACTCCC
ATGTCAACCAT -> TGTCAACCATC
ATGTCCAGTTC -> TGTCCAGTTCG
ATGTGCTACAA -> TGTGCTACAAT
ATGTGGAGGTT -> TGTGGAGGTTT
ATGTGGTCTGC -> TGTGGTCTGCA
ATGTGTGCATC -> TGTGTGCATCC
ATGTTAGGTCA -> TGTTAGGTCAT
ATGTTCACAGA -> TGTTCACAGAT
ATGTTCTAACA -> TGTTCTAACAA
ATTAAATCAGG -> TTAAATCAGGT
ATTACCCCGGT -> TTACCCCGGTA
ATTAGAGCTAA -> TTAGAGCTAAA
ATTAGCTTACG -> TTAGCTTACGT
ATTATAAGATG -> TTATAAGATGA
ATTATCACAAT -> TTATCACAATC
ATTATGCGGGT -> TTATGCGGGTA
ATTCAGCCCCC -> TTCAGCCCCCG
ATTCATAGTGG -> TTCATAGTGGC
ATTCATTAGCT -> TTCATTAGCTT
ATTCCGACTTA -> TTCCGACTTAC
ATTCTATATAT -> TTCTATATATA
ATTGAACTGTA -> TTGAACTGTAG
ATTGCATATCA -> TTGCATATCAC
ATTGCGTATAA -> TTGCGTATAAT
ATTGGTAACTC -> TTGGTAACTCA
ATTTAGGTGGA -> TTTAGGTGGAG
ATTTATAGAAA -> TTTATAGAAAT
ATTTCTGGAAT -> TTTCTGGAATA
ATTTGATCCAG -> TTTGATCCAGC
ATTTGGTGAGA -> TTTGGTGAGAC
ATTTTATACCT -> TTTTATACCTA
ATTTTGCCGCG -> TTTTGCCGCGA
CAAACTTGAAT -> AAACTTGAATT
CAAAGCCCCCA -> AAAGCCCCCAG
CAAAGCTTCTT -> AAAGCTTCTTA
CAAATCGAGCT -> AAATCGAGCTC
CAACCAGATTG -> AACCAGATTGC
CAACCATCTTG -> AACCATCTTGG
CAACGAGCCCT -> AACGAGCCCTA
CAACGGGAACG -> AACGGGAACGG
CAACGTCTATC -> AACGTCTATCC
CAACGTCTGAG -> AACGTCTGAGG
CAACTATTATG -> AACTATTATGC
CAAGAAGCGAG -> AAGAAGCGAGT
CAAGCACCCGG -> AAGCACCCGGC
CAAGGAACGAG -> AAGGAACGAGT
CAAGGCCGGCT -> AAGGCCGGCTA
CAAGTCTTAAA -> AAGTCTTAAAC
CAAGTGGTACG -> AAGTGGTACGC
CAATACGTTAG -> AATACGTTAGC
CAATCACCGCC -> AATCACCGCCC
CAATCGGAAGC -> AATCGGAAGCC
CAATCGGACAC -> AATCGGACACT
CAATGTCCAGT -> AATGTCCAGTT
CACAAACTTGA -> ACAAACTTGAA
CACAACGAGCC -> ACAACGAGCCC
CACAATCGGAA -> ACAATCGGAAG
CACACAGTGGA -> ACACAGTGGAG
CACACCCGCAG -> ACACCCGCAGT
CACACTATGTA -> ACACTATGTAG
CACAGATATCT -> ACAGATATCTC
CACAGATGTGC -> ACAGATGTGCT
CACAGCCACTC -> ACAGCCACTCT
CACAGTGGAGG -> ACAGTGGAGGT
CACAGTTGCAG -> ACAGTTGCAGC
CACATGGATGC -> ACATGGATGCA
CACCACTTGTC -> ACCACTTGTCT
CACCCAACGGG -> ACCCAACGGGA
CACCCGCAGTA -> ACCCGCAGTAG
CACCCGGCGAA -> ACCCGGCGAAA
CACCGCCCAAG -> ACCGCCCAAGA
CACCTAATACG -> ACCTAATACGA
CACCTTTGCTC -> ACCTTTGCTCC
CACGAGCTTGT -> ACGAGCTTGTT
CACGATTCAGC -> ACGATTCAGCC
CACGCATGATC -> ACGCATGATCA
CACGCCCATTC -> ACGCCCATTCC
CACGCCTTAAT -> ACGCCTTAATA
CACGCTAGTCG -> ACGCTAGTCGC
CACGTTGACGA -> ACGTTGACGAC
CACTAGATAGA -> ACTAGATAGAA
CACTATGTAGA -> ACTATGTAGAC
CACTCTATACC -> ACTCTATACCC
CACTGTTACCA -> ACTGTTACCAT
CACTTCGAAAA -> ACTTCGAAAAC
CACTTGTCTCA -> ACTTGTCTCAG
CAGAACCGTCA -> AGAACCGTCAA
CAGAACTACAG -> AGAACTACAGT
CAGACGATCCA -> AGACGATCCAA
CAGAGCCGCGT -> AGAGCCGCGTC
CAGATAAAATG -> AGATAAAATGC
CAGATATCTCG -> AGATATCTCGC
CAGATGTGCTA -> AGATGTGCTAC
CAGATTGCGTA -> AGATTGCGTAT
CAGCAATCACC -> AGCAATCACCG
CAGCAGCGACA -> AGCAGCGACAT
CAGCCACTCTA -> AGCCACTCTAT
CAGCCAGGTCC -> AGCCAGGTCCG
CAGCCCCCGGG -> AGCCCCCGGGG
CAGCGACATGT -> AGCGACATGTG
CAGCGAGAGTG -> AGCGAGAGTGC
CAGCGCCCCTT -> AGCGCCCCTTA
CAGCGCGGAGC -> AGCGCGGAGCC
CAGCTACACGC -> AGCTACACGCT
CAGCTACGGTC -> AGCTACGGTCG
CAGCTCACAAA -> AGCTCACAAAC
CAGCTGAAACA -> AGCTGAAACAG
CAGGAGGTCGG -> AGGAGGTCGGA
CAGGGCCATTC -> AGGGCCATTCA
CAGGGCGATTA -> AGGGCGATTAC
CAGGGCGCATG -> AGGGCGCATGC
CAGGGGCTCTC -> AGGGGCTCTCG
CAGGTCCGTGA -> AGGTCCGTGAG
CAGGTGTATCC -> AGGTGTATCCT
CAGTACCATAG -> AGTACCATAGC
CAGTACTACGA -> AGTACTACGAG
CAGTAGAAATG -> AGTAGAAATGT
CAGTATCGGAT -> AGTATCGGATC
CAGTGGAGGTA -> AGTGGAGGTAC
CAGTGTCAGAG -> AGTGTCAGAGC
CAGTGTTTCAT -> AGTGTTTCATA
CAGTTCGCAGA -> AGTTCGCAGAA
CAGTTCTATGT -> AGTTCTATGTG
CAGTTGCAGCT -> AGTTGCAGCTC
CAGTTGGGACT -> AGTTGGGACTA
CATACTCGAAC -> ATACTCGAACC
CATACTGTAAA -> ATACTGTAAAT
CATAGCGTTGA -> ATAGCGTTGAG
CATAGCTTCGG -> ATAGCTTCGGT
CATAGGGGTCG -> ATAGGGGTCGT
CATAGTGGCTA -> ATAGTGGCTAG
CATATCACACA -> ATATCACACAG
CATCACAGTTG -> ATCACAGTTGC
CATCAGCAGCG -> ATCAGCAGCGA
CATCCATTAAA -> ATCCATTAAAT
CATCGGTTAAT -> ATCGGTTAATA
CATCGTTGTCC -> ATCGTTGTCCC
CATCTCACTAG -> ATCTCACTAGA
CATCTCTAAGC -> ATCTCTAAGCT
CATCTGATAGG -> ATCTGATAGGG
CATCTTGGTTT -> ATCTTGGTTTT
CATGACCACAG -> ATGACCACAGA
CATGAGTATGC -> ATGAGTATGCC
CATGATCAGAC -> ATGATCAGACG
CATGCAGCAAT -> ATGCAGCAATC
CATGCAGGGCG -> ATGCAGGGCGA
CATGCGGAAGG -> ATGCGGAAGGG
CATGCGGATAC -> ATGCGGATACG
CATGGAATATG -> ATGGAATATGG
CATGGATGCAC -> ATGGATGCACG
CATGGGTGGCA -> ATGGGTGGCAG
CATGTGGAGGT -> ATGTGGAGGTT
CATTAAATCAG -> ATTAAATCAGG
CATTAGCTTAC -> ATTAGCTTACG
CATTATCACAA -> ATTATCACAAT
CATTCATTAGC -> ATTCATTAGCT
CATTCCGACTT -> ATTCCGACTTA
CATTTATAGAA -> ATTTATAGAAA
CCAAAGCCCCC -> CAAAGCCCCCA
CCAACGGGAAC -> CAACGGGAACG
CCAACGTCTAT -> CAACGTCTATC
CCAACGTCTGA -> CAACGTCTGAG
CCAACTATTAT -> CAACTATTATG
CCAAGAAGCGA -> CAAGAAGCGAG
CCAAGGAACGA -> CAAGGAACGAG
CCAAGTCTTAA -> CAAGTCTTAAA
CCACAACGAGC -> CACAACGAGCC
CCACAGATATC -> CACAGATATCT
CCACGAGCTTG -> CACGAGCTTGT
CCACTCTATAC -> CACTCTATACC
CCACTTGTCTC -> CACTTGTCTCA
CCAGAACCGTC -> CAGAACCGTCA
CCAGATTGCGT -> CAGATTGCGTA
CCAGCCAGGTC -> CAGCCAGGTCC
CCAGCGCGGAG -> CAGCGCGGAGC
CCAGGAGGTCG -> CAGGAGGTCGG
CCAGGTCCGTG -> CAGGTCCGTGA
CCAGTTCGCAG -> CAGTTCGCAGA
CCATAGCGTTG -> CATAGCGTTGA
CCATAGGGGTC -> CATAGGGGTCG
CCATCTCACTA -> CATCTCACTAG
CCATCTGATAG -> CATCTGATAGG
CCATCTTGGTT -> CATCTTGGTTT
CCATGCGGAAG -> CATGCGGAAGG
CCATTAAATCA -> CATTAAATCAG
CCATTATCACA -> CATTATCACAA
CCATTCATTAG -> CATTCATTAGC
CCATTCCGACT -> CATTCCGACTT
CCATTTATAGA -> CATTTATAGAA
CCCAACGGGAA -> CCAACGGGAAC
CCCAACGTCTG -> CCAACGTCTGA
CCCAAGAAGCG -> CCAAGAAGCGA
CCCAAGGAACG -> CCAAGGAACGA
CCCACAACGAG -> CCACAACGAGC
CCCAGCGCGGA -> CCAGCGCGGAG
CCCAGGAGGTC -> CCAGGAGGTCG
CCCATAGGGGT -> CCATAGGGGTC
CCCATTATCAC -> CCATTATCACA
CCCATTCCGAC -> CCATTCCGACT
CCCATTTATAG -> CCATTTATAGA
CCCCAACGTCT -> CCCAACGTCTG
CCCCAGCGCGG -> CCCAGCGCGGA
CCCCAGGAGGT -> CCCAGGAGGTC
CCCCCAGCGCG -> CCCCAGCGCGG
CCCCCGAGACG -> CCCCGAGACGC
CCCCCGGGGCA -> CCCCGGGGCAG
CCCCGAGACGC -> CCCGAGACGCT
CCCCGCTTTCG -> CCCGCTTTCGG
CCCCGGGGCAG -> CCCGGGGCAGC
CCCCGGTATTT -> CCCGGTATTTG
CCCCTATCCAA -> CCCTATCCAAC
CCCCTTATAGG -> CCCTTATAGGA
CCCGAAGATAG -> CCGAAGATAGG
CCCGAGACGCT -> CCGAGACGCTA
CCCGAGTTAAT -> CCGAGTTAATC
CCCGCAGTAGA -> CCGCAGTAGAA
CCCGCTATCGG -> CCGCTATCGGT
CCCGCTTTCGG -> CCGCTTTCGGC
CCCGGCGAAAG -> CCGGCGAAAGC
CCCGGGCCTGC -> CCGGGCCTGCA
CCCGGGGCAGC -> CCGGGGCAGCG
CCCGGTATTTG -> CCGGTATTTGG
CCCGTTGGTTT -> CCGTTGGTTTC
CCCTAAGGTGG -> CCTAAGGTGGT
CCCTATCCAAC -> CCTATCCAACG
CCCTCCAACTA -> CCTCCAACTAT
CCCTTATAGGA -> CCTTATAGGAT
CCGAAGATAGG -> CGAAGATAGGG
CCGACTTACCG -> CGACTTACCGA
CCGAGACGCTA -> CGAGACGCTAC
CCGAGATTGGT -> CGAGATTGGTA
CCGAGCTGAGT -> CGAGCTGAGTG
CCGAGTTAATC -> CGAGTTAATCG
CCGATTTAGGT -> CGATTTAGGTG
CCGCAGTAGAA -> CGCAGTAGAAA
CCGCCCAAGAA -> CGCCCAAGAAG
CCGCGAACCAC -> CGCGAACCACG
CCGCGTCAGAT -> CGCGTCAGATA
CCGCTATCGGT -> CGCTATCGGTG
CCGCTTTCGGC -> CGCTTTCGGCC
CCGGCCTTGCC -> CGGCCTTGCCC
CCGGCGAAAAC -> CGGCGAAAACT
CCGGCGAAAGC -> CGGCGAAAGCG
CCGGCTAAAAA -> CGGCTAAAAAA
CCGGGCCTGCA -> CGGGCCTGCAG
CCGGGGCAGCG -> CGGGGCAGCGA
CCGGGGCCTTC -> CGGGGCCTTCC
CCGGTATTTGG -> CGGTATTTGGT
CCGTCAAGCAC -> CGTCAAGCACC
CCGTCCAGAAC -> CGTCCAGAACC
CCGTGAGAAGC -> CGTGAGAAGCC
CCGTTGGTTTC -> CGTTGGTTTCA
CCTAAGGTGGT -> CTAAGGTGGTC
CCTAATACGAG -> CTAATACGAGT
CCTACAGGGCC -> CTACAGGGCCA
CCTAGGGACCC -> CTAGGGACCCG
CCTATCCAACG -> CTATCCAACGT
CCTATCGAGGG -> CTATCGAGGGT
CCTCAATCGGA -> CTCAATCGGAC
CCTCCAACTAT -> CTCCAACTATT
CCTCTGCATGC -> CTCTGCATGCG
CCTCTTTGCAT -> CTCTTTGCATC
CCTGCAGTGTC -> CTGCAGTGTCA
CCTTAATAAGG -> CTTAATAAGGG
CCTTATAGGAT -> CTTATAGGATA
CCTTCCGGCCT -> CTTCCGGCCTT
CCTTCGCGCTG -> CTTCGCGCTGA
CCTTCGCGCTT -> CTTCGCGCTTT
CCTTGATTCAT -> CTTGATTCATA
CCTTGCCCACA -> CTTGCCCACAA
CCTTGCCCTCC -> CTTGCCCTCCA
CCTTGGCAACC -> CTTGGCAACCA
CCTTTACCCAT -> CTTTACCCATT
CCTTTGCTCCT -> CTTTGCTCCTA
CGAAAACTATC -> GAAAACTATCT
CGAAAACTCGT -> GAAAACTCGTT
CGAAAGCGAAC -> GAAAGCGAACA
CGAACACCTAA -> GAACACCTAAT
CGAACCACGAG -> GAACCACGAGC
CGAACCCATTA -> GAACCCATTAT
CGAAGATAGGG -> GAAGATAGGGT
CGAAGTCCGGG -> GAAGTCCGGGG
CGAATTGAACT -> GAATTGAACTG
CGACACAGCCA -> GACACAGCCAC
CGACATACTCG -> GACATACTCGA
CGACATGTGGA -> GACATGTGGAG
CGACGATGACT -> GACGATGACTT
CGACGGCGAGG -> GACGGCGAGGT
CGACTCTCATG -> GACTCTCATGA
CGACTTACCGA -> GACTTACCGAG
CGACTTGTTTG -> GACTTGTTTGA
CGAGACGCTAC -> GAGACGCTACG
CGAGAGCATAG -> GAGAGCATAGC
CGAGAGTGCTT -> GAGAGTGCTTT
CGAGATTGGTA -> GAGATTGGTAA
CGAGCATCGGT -> GAGCATCGGTT
CGAGCCCTAAG -> GAGCCCTAAGG
CGAGCTCTTTC -> GAGCTCTTTCT
CGAGCTGAGTG -> GAGCTGAGTGA
CGAGCTTGTTC -> GAGCTTGTTCA
CGAGGGCAGCT -> GAGGGCAGCTA
CGAGGGTCCCC -> GAGGGTCCCCT
CGAGGGTTATG -> GAGGGTTATGG
CGAGGTGGAAG -> GAGGTGGAAGT
CGAGTAAGATT -> GAGTAAGATTT
CGAGTAGAATG -> GAGTAGAATGG
CGAGTCGCGAC -> GAGTCGCGACA
CGAGTGCGTCA -> GAGTGCGTCAG
CGAGTTAATCG -> GAGTTAATCGC
CGATCCAAGTC -> GATCCAAGTCT
CGATGACTTAA -> GATGACTTAAG
CGATGCTTTCT -> GATGCTTTCTT
CGATTACCCCG -> GATTACCCCGG
CGATTCAGCCC -> GATTCAGCCCC
CGATTTAGGTG -> GATTTAGGTGG
CGCAGAACTAC -> GCAGAACTACA
CGCAGTACCAT -> GCAGTACCATA
CGCAGTACTAC -> GCAGTACTACG
CGCAGTAGAAA -> GCAGTAGAAAT
CGCATCGTTGT -> GCATCGTTGTC
CGCATGATCAG -> GCATGATCAGA
CGCATGCAGGG -> GCATGCAGGGC
CGCCATCTCAC -> GCCATCTCACT
CGCCCAAGAAG -> GCCCAAGAAGC
CGCCCATTCCG -> GCCCATTCCGA
CGCCCCTTATA -> GCCCCTTATAG
CGCCTCAATCG -> GCCTCAATCGG
CGCCTCTTTGC -> GCCTCTTTGCA
CGCCTTAATAA -> GCCTTAATAAG
CGCCTTTACCC -> GCCTTTACCCA
CGCGAACCACG -> GCGAACCACGA
CGCGACATACT -> GCGACATACTC
CGCGAGCATCG -> GCGAGCATCGG
CGCGATGCTTT -> GCGATGCTTTC
CGCGCGAGCAT -> GCGCGAGCATC
CGCGCTGACGA -> GCGCTGACGAG
CGCGCTTTAGG -> GCGCTTTAGGA
CGCGGAGCCGA -> GCGGAGCCGAT
CGCGTACAATA -> GCGTACAATAC
CGCGTCAGATA -> GCGTCAGATAA
CGCTACGTTTC -> GCTACGTTTCG
CGCTAGTCGCG -> GCTAGTCGCGA
CGCTATCGGTG -> GCTATCGGTGT
CGCTCAGCTGA -> GCTCAGCTGAA
CGCTGACGAGT -> GCTGACGAGTA
CGCTGATTTGA -> GCTGATTTGAT
CGCTTTAGGAA -> GCTTTAGGAAA
CGCTTTCGGCC -> GCTTTCGGCCT
CGGAAGCCCGA -> GGAAGCCCGAA
CGGAAGGGCGA -> GGAAGGGCGAA
CGGACACTTCG -> GGACACTTCGA
CGGAGATCCTT -> GGAGATCCTTG
CGGAGCCGATT -> GGAGCCGATTT
CGGATACGTGC -> GGATACGTGCG
CGGATCTCGTT -> GGATCTCGTTC
CGGCCTTCGCG -> GGCCTTCGCGC
CGGCCTTGCCC -> GGCCTTGCCCA
CGGCGAAAACT -> GGCGAAAACTA
CGGCGAAAGCG -> GGCGAAAGCGA
CGGCGAGGTGG -> GGCGAGGTGGA
CGGCGCATCGT -> GGCGCATCGTT
CGGCTAAAAAA -> GGCTAAAAAAA
CGGGAACGGTG -> GGGAACGGTGG
CGGGCCTGCAG -> GGGCCTGCAGT
CGGGGCAGCGA -> GGGGCAGCGAG
CGGGGCCTTCC -> GGGGCCTTCCG
CGGGTATGTTC -> GGGTATGTTCA
CGGTATTTGGT -> GGTATTTGGTG
CGGTCGTCTTG -> GGTCGTCTTGG
CGGTGGGATGA -> GGTGGGATGAA
CGGTGTGTCAC -> GGTGTGTCACG
CGGTGTTTATA -> GGTGTTTATAA
CGGTTAATACA -> GGTTAATACAA
CGTACAATACG -> GTACAATACGT
CGTAGGTAAAC -> GTAGGTAAACT
CGTATAATCAC -> GTATAATCACT
CGTCAAGCACC -> GTCAAGCACCC
CGTCAGATAAA -> GTCAGATAAAA
CGTCAGGGGCT -> GTCAGGGGCTC
CGTCCAGAACC -> GTCCAGAACCG
CGTCTATCCTT -> GTCTATCCTTG
CGTCTGAGGAG -> GTCTGAGGAGG
CGTCTTATACA -> GTCTTATACAT
CGTCTTGGTTA -> GTCTTGGTTAG
CGTGAGAAGCC -> GTGAGAAGCCC
CGTGCGAGGGC -> GTGCGAGGGCA
CGTGGTCTTCC -> GTGGTCTTCCC
CGTTAGCTACT -> GTTAGCTACTT
CGTTCCCAAGG -> GTTCCCAAGGA
CGTTCCCCCGA -> GTTCCCCCGAG
CGTTGACGACG -> GTTGACGACGG
CGTTGAGAACT -> GTTGAGAACTC
CGTTGAGACTT -> GTTGAGACTTT
CGTTGGTTTCA -> GTTGGTTTCAC
CGTTGTCCCCG -> GTTGTCCCCGC
CGTTGTCTTCC -> GTTGTCTTCCA
CGTTTCGACTC -> GTTTCGACTCT
CGTTTGCTTAC -> GTTTGCTTACT
CGTTTGGCCGT -> GTTTGGCCGTC
CTAAAAAAAAC -> TAAAAAAAACT
CTAAAAAAGAA -> TAAAAAAGAAG
CTAAAAGCATG -> TAAAAGCATGG
CTAACAAGGCC -> TAACAAGGCCG
CTAAGCTGAAT -> TAAGCTGAATC
CTAAGGTGGTC -> TAAGGTGGTCG
CTAATACGAGT -> TAATACGAGTA
CTAATTAGAGC -> TAATTAGAGCT
CTACAATGTCC -> TACAATGTCCA
CTACACGCTAG -> TACACGCTAGT
CTACAGGGCCA -> TACAGGGCCAT
CTACAGTTCTA -> TACAGTTCTAT
CTACGAGAGCA -> TACGAGAGCAT
CTACGGTCGTC -> TACGGTCGTCT
CTACGTCTTAT -> TACGTCTTATA
CTACGTTTCGA -> TACGTTTCGAC
CTACTTGAGAG -> TACTTGAGAGT
CTAGAGCGCCT -> TAGAGCGCCTC
CTAGATAGAAG -> TAGATAGAAGT
CTAGCAAATCG -> TAGCAAATCGA
CTAGGGACCCG -> TAGGGACCCGC
CTAGTCGCGAT -> TAGTCGCGATG
CTATACCCCAA -> TATACCCCAAC
CTATATATATT -> TATATATATTA
CTATCCAACGT -> TATCCAACGTC
CTATCCTTGCC -> TATCCTTGCCC
CTATCGAGGGT -> TATCGAGGGTC
CTATCGGTGTT -> TATCGGTGTTT
CTATCTTGAGC -> TATCTTGAGCT
CTATGGATTCT -> TATGGATTCTA
CTATGTAGACT -> TATGTAGACTC
CTATGTGGTCT -> TATGTGGTCTG
CTATGTTAGGT -> TATGTTAGGTC
CTATTATGCGG -> TATTATGCGGG
CTCAATCGGAC -> TCAATCGGACA
CTCACAAACTT -> TCACAAACTTG
CTCACACCCGC -> TCACACCCGCA
CTCACACTATG -> TCACACTATGT
CTCACGCATGA -> TCACGCATGAT
CTCACGTTGAC -> TCACGTTGACG
CTCACTAGATA -> TCACTAGATAG
CTCAGCTACGG -> TCAGCTACGGT
CTCAGCTGAAA -> TCAGCTGAAAC
CTCATGACCAC -> TCATGACCACA
CTCCAACTATT -> TCCAACTATTA
CTCCCCAGGAG -> TCCCCAGGAGG
CTCCTAGGGAC -> TCCTAGGGACC
CTCGAACCCAT -> TCGAACCCATT
CTCGCAGTACC -> TCGCAGTACCA
CTCGCCTTTAC -> TCGCCTTTACC
CTCGTTCCCAA -> TCGTTCCCAAG
CTCGTTCCCCC -> TCGTTCCCCCG
CTCGTTTGCTT -> TCGTTTGCTTA
CTCTAAGCTGA -> TCTAAGCTGAA
CTCTATACCCC -> TCTATACCCCA
CTCTCATGACC -> TCTCATGACCA
CTCTCGTTTGC -> TCTCGTTTGCT
CTCTGCATGCG -> TCTGCATGCGG
CTCTTTCTTCT -> TCTTTCTTCTA
CTCTTTGCATC -> TCTTTGCATCA
CTGAAACAGTG -> TGAAACAGTGT
CTGAATCAGCG -> TGAATCAGCGC
CTGACGAGTAA -> TGACGAGTAAG
CTGAGGAGGCT -> TGAGGAGGCTA
CTGAGTGATTT -> TGAGTGATTTT
CTGATACAGTA -> TGATACAGTAT
CTGATAGGGGA -> TGATAGGGGAG
CTGATTTGATC -> TGATTTGATCC
CTGCAGTGTCA -> TGCAGTGTCAG
CTGCATCTCTA -> TGCATCTCTAA
CTGCATGCGGA -> TGCATGCGGAT
CTGGAATACGC -> TGGAATACGCT
CTGTAAATAAG -> TGTAAATAAGC
CTGTAGGGCCT -> TGTAGGGCCTT
CTGTCTTACTA -> TGTCTTACTAA
CTGTGCATCAG -> TGTGCATCAGC
CTGTGGGAATA -> TGTGGGAATAA
CTGTTACCATC -> TGTTACCATCT
CTGTTGCGAGG -> TGTTGCGAGGG
CTTAAACGCAG -> TTAAACGCAGT
CTTAAATTGCA -> TTAAATTGCAT
CTTAAGGCCGA -> TTAAGGCCGAG
CTTAATAAGGG -> TTAATAAGGGA
CTTACCGAGAT -> TTACCGAGATT
CTTACGTTGAG -> TTACGTTGAGA
CTTACTAATTA -> TTACTAATTAG
CTTACTCACAC -> TTACTCACACC
CTTATACATGC -> TTATACATGCA
CTTATAGGATA -> TTATAGGATAC
CTTCCATGCGG -> TTCCATGCGGA
CTTCCCGAGTT -> TTCCCGAGTTA
CTTCCGGCCTT -> TTCCGGCCTTG
CTTCGAAAACT -> TTCGAAAACTC
CTTCGCGCTGA -> TTCGCGCTGAC
CTTCGCGCTTT -> TTCGCGCTTTA
CTTCGGTGTGT -> TTCGGTGTGTC
CTTCTATGGAT -> TTCTATGGATT
CTTCTTAAATT -> TTCTTAAATTG
CTTGAATTTCT -> TTGAATTTCTG
CTTGAGAGTAT -> TTGAGAGTATA
CTTGAGCTGTC -> TTGAGCTGTCT
CTTGATTCATA -> TTGATTCATAG
CTTGCCCACAA -> TTGCCCACAAC
CTTGCCCTCCA -> TTGCCCTCCAA
CTTGGCAACCA -> TTGGCAACCAG
CTTGGTTAGAA -> TTGGTTAGAAT
CTTGGTTTTTG -> TTGGTTTTTGG
CTTGTCTCAGC -> TTGTCTCAGCT
CTTGTTCATGG -> TTGTTCATGGG
CTTGTTTGAGC -> TTGTTTGAGCT
CTTTAAGACGA -> TTTAAGACGAA
CTTTACCCATT -> TTTACCCATTT
CTTTAGGAAAT -> TTTAGGAAATG
CTTTCGGCCTT -> TTTCGGCCTTC
CTTTCTTCTAT -> TTTCTTCTATG
CTTTCTTTTCA -> TTTCTTTTCAC
CTTTGCATCAC -> TTTGCATCACA
CTTTGCTCCTA -> TTTGCTCCTAG
CTTTTCACCCA -> TTTTCACCCAA
CTTTTCACGCC -> TTTTCACGCCT
CTTTTGCGGCG -> TTTTGCGGCGC
GAAAACTATCT -> AAAACTATCTT
GAAAACTCGTT -> AAAACTCGTTC
GAAACAGTGTT -> AAACAGTGTTT
GAAACTGTGGG -> AAACTGTGGGA
GAAAGCGAACA -> AAAGCGAACAC
GAAATGCTACG -> AAATGCTACGT
GAAATGTGTGC -> AAATGTGTGCA
GAAATGTTCTA -> AAATGTTCTAA
GAACACCTAAT -> AACACCTAATA
GAACCACGAGC -> AACCACGAGCT
GAACCCATTAT -> AACCCATTATC
GAACCGTCAAG -> AACCGTCAAGC
GAACGACTTGT -> AACGACTTGTT
GAACGAGTGCG -> AACGAGTGCGT
GAACGCTGATT -> AACGCTGATTT
GAACGGTGGGA -> AACGGTGGGAT
GAACTACAGTT -> AACTACAGTTC
GAACTCACGCA -> AACTCACGCAT
GAACTGTAGGG -> AACTGTAGGGC
GAAGATAGGGT -> AAGATAGGGTT
GAAGCCCGAAG -> AAGCCCGAAGA
GAAGCCCGGGC -> AAGCCCGGGCC
GAAGCGAGTCG -> AAGCGAGTCGC
GAAGGGCGAAT -> AAGGGCGAATT
GAAGTACGCCT -> AAGTACGCCTC
GAAGTCCGGGG -> AAGTCCGGGGC
GAAGTCGTTGT -> AAGTCGTTGTC
GAAGTTGACGT -> AAGTTGACGTG
GAATAACAAGT -> AATAACAAGTG
GAATACGCTCA -> AATACGCTCAG
GAATATGGGAC -> AATATGGGACC
GAATCAGCGCC -> AATCAGCGCCC
GAATGGGTTGA -> AATGGGTTGAA
GAATGTCAACC -> AATGTCAACCA
GAATTGAACTG -> AATTGAACTGT
GAATTTCTGGA -> AATTTCTGGAA
GACACAGCCAC -> ACACAGCCACT
GACACCTTTGC -> ACACCTTTGCT
GACACTTCGAA -> ACACTTCGAAA
GACATACTCGA -> ACATACTCGAA
GACATGTGGAG -> ACATGTGGAGG
GACCAAAGCCC -> ACCAAAGCCCC
GACCACAGATA -> ACCACAGATAT
GACCCGCTATC -> ACCCGCTATCG
GACCTTCGCGC -> ACCTTCGCGCT
GACGAAGTCCG -> ACGAAGTCCGG
GACGACGGCGA -> ACGACGGCGAG
GACGAGTAAGA -> ACGAGTAAGAT
GACGATCCAAG -> ACGATCCAAGT
GACGATGACTT -> ACGATGACTTA
GACGCTACGTT -> ACGCTACGTTT
GACGGCGAGGT -> ACGGCGAGGTG
GACGTGGTCTT -> ACGTGGTCTTC
GACTATGTTAG -> ACTATGTTAGG
GACTCCCCAGG -> ACTCCCCAGGA
GACTCTCATGA -> ACTCTCATGAC
GACTTAAGGCC -> ACTTAAGGCCG
GACTTACCGAG -> ACTTACCGAGA
GACTTGTTTGA -> ACTTGTTTGAG
GACTTTAAGAC -> ACTTTAAGACG
GAGAACTCACG -> AGAACTCACGC
GAGAAGCCCGG -> AGAAGCCCGGG
GAGAAGTACGC -> AGAAGTACGCC
GAGACACCTTT -> AGACACCTTTG
GAGACGCTACG -> AGACGCTACGT
GAGACTTTAAG -> AGACTTTAAGA
GAGAGCATAGC -> AGAGCATAGCT
GAGAGTATAGA -> AGAGTATAGAA
GAGAGTGCTTT -> AGAGTGCTTTT
GAGATCCTTGG -> AGATCCTTGGC
GAGATTGGTAA -> AGATTGGTAAC
GAGCATAGCTT -> AGCATAGCTTC
GAGCATCGGTT -> AGCATCGGTTA
GAGCCCTAAGG -> AGCCCTAAGGT
GAGCCGATTTA -> AGCCGATTTAG
GAGCCGCGTCA -> AGCCGCGTCAG
GAGCGCCTCTT -> AGCGCCTCTTT
GAGCTAAAAAA -> AGCTAAAAAAG
GAGCTCGCCTT -> AGCTCGCCTTT
GAGCTCTTTCT -> AGCTCTTTCTT
GAGCTGAGTGA -> AGCTGAGTGAT
GAGCTGTCTTA -> AGCTGTCTTAC
GAGCTTGTTCA -> AGCTTGTTCAT
GAGGAGGCTAA -> AGGAGGCTAAA
GAGGCTAAAAG -> AGGCTAAAAGC
GAGGGCAGCTA -> AGGGCAGCTAC
GAGGGTCCCCT -> AGGGTCCCCTA
GAGGGTTATGG -> AGGGTTATGGC
GAGGTACGCGT -> AGGTACGCGTA
GAGGTCGGAGA -> AGGTCGGAGAT
GAGGTGGAAGT -> AGGTGGAAGTT
GAGGTTTTTAT -> AGGTTTTTATC
GAGGTTTTTGC -> AGGTTTTTGCT
GAGTAAGATTT -> AGTAAGATTTT
GAGTACTGTGC -> AGTACTGTGCA
GAGTAGAATGG -> AGTAGAATGGG
GAGTATAGAAC -> AGTATAGAACG
GAGTATGCCGG -> AGTATGCCGGC
GAGTCGCGACA -> AGTCGCGACAT
GAGTGATTTTG -> AGTGATTTTGC
GAGTGCGTCAG -> AGTGCGTCAGG
GAGTGCTTTTG -> AGTGCTTTTGC
GAGTTAATCGC -> AGTTAATCGCG
GATAAAATGCG -> ATAAAATGCGA
GATACAGTATC -> ATACAGTATCG
GATACGTGCGA -> ATACGTGCGAG
GATACTGTTGC -> ATACTGTTGCG
GATAGAAGTCG -> ATAGAAGTCGT
GATAGGGGAGA -> ATAGGGGAGAA
GATAGGGTTCC -> ATAGGGTTCCC
GATATCTCGCA -> ATATCTCGCAG
GATCAGACGAT -> ATCAGACGATC
GATCCAAGTCT -> ATCCAAGTCTT
GATCCAGCCAG -> ATCCAGCCAGG
GATCCTTGGCA -> ATCCTTGGCAA
GATCGTTTGGC -> ATCGTTTGGCC
GATCTCGTTCC -> ATCTCGTTCCC
GATGAACGACT -> ATGAACGACTT
GATGACTTAAG -> ATGACTTAAGG
GATGATCGTTT -> ATGATCGTTTG
GATGCACGCCC -> ATGCACGCCCA
GATGCTTTCTT -> ATGCTTTCTTT
GATGTGCTACA -> ATGTGCTACAA
GATTACCCCGG -> ATTACCCCGGT
GATTCAGCCCC -> ATTCAGCCCCC
GATTCATAGTG -> ATTCATAGTGG
GATTCTATATA -> ATTCTATATAT
GATTGCGTATA -> ATTGCGTATAA
GATTGGTAACT -> ATTGGTAACTC
GATTTAGGTGG -> ATTTAGGTGGA
GATTTGATCCA -> ATTTGATCCAG
GATTTTATACC -> ATTTTATACCT
GATTTTGCCGC -> ATTTTGCCGCG
GCAAATCGAGC -> CAAATCGAGCT
GCAACCAGATT -> CAACCAGATTG
GCAATCACCGC -> CAATCACCGCC
GCACCCGGCGA -> CACCCGGCGAA
GCACGCCCATT -> CACGCCCATTC
GCAGAACTACA -> CAGAACTACAG
GCAGCAATCAC -> CAGCAATCACC
GCAGCGACATG -> CAGCGACATGT
GCAGCGAGAGT -> CAGCGAGAGTG
GCAGCTACACG -> CAGCTACACGC
GCAGCTCACAA -> CAGCTCACAAA
GCAGGGCGATT -> CAGGGCGATTA
GCAGGGCGCAT -> CAGGGCGCATG
GCAGTACCATA -> CAGTACCATAG
GCAGTACTACG -> CAGTACTACGA
GCAGTAGAAAT -> CAGTAGAAATG
GCAGTGTCAGA -> CAGTGTCAGAG
GCATAGCTTCG -> CATAGCTTCGG
GCATATCACAC -> CATATCACACA
GCATCACAGTT -> CATCACAGTTG
GCATCAGCAGC -> CATCAGCAGCG
GCATCCATTAA -> CATCCATTAAA
GCATCGGTTAA -> CATCGGTTAAT
GCATCGTTGTC -> CATCGTTGTCC
GCATCTCTAAG -> CATCTCTAAGC
GCATGATCAGA -> CATGATCAGAC
GCATGCAGGGC -> CATGCAGGGCG
GCATGCGGATA -> CATGCGGATAC
GCATGGAATAT -> CATGGAATATG
GCCACTCTATA -> CCACTCTATAC
GCCAGGTCCGT -> CCAGGTCCGTG
GCCATCTCACT -> CCATCTCACTA
GCCATTCATTA -> CCATTCATTAG
GCCCAAGAAGC -> CCCAAGAAGCG
GCCCACAACGA -> CCCACAACGAG
GCCCATAGGGG -> CCCATAGGGGT
GCCCATTCCGA -> CCCATTCCGAC
GCCCCCAGCGC -> CCCCCAGCGCG
GCCCCCGGGGC -> CCCCCGGGGCA
GCCCCTTATAG -> CCCCTTATAGG
GCCCGAAGATA -> CCCGAAGATAG
GCCCGGGCCTG -> CCCGGGCCTGC
GCCCTAAGGTG -> CCCTAAGGTGG
GCCCTCCAACT -> CCCTCCAACTA
GCCGAGCTGAG -> CCGAGCTGAGT
GCCGATTTAGG -> CCGATTTAGGT
GCCGCGAACCA -> CCGCGAACCAC
GCCGCGTCAGA -> CCGCGTCAGAT
GCCGGCGAAAA -> CCGGCGAAAAC
GCCGGCTAAAA -> CCGGCTAAAAA
GCCGTCCAGAA -> CCGTCCAGAAC
GCCTCAATCGG -> CCTCAATCGGA
GCCTCTTTGCA -> CCTCTTTGCAT
GCCTGCAGTGT -> CCTGCAGTGTC
GCCTTAATAAG -> CCTTAATAAGG
GCCTTCCGGCC -> CCTTCCGGCCT
GCCTTCGCGCT -> CCTTCGCGCTG
GCCTTGATTCA -> CCTTGATTCAT
GCCTTGCCCAC -> CCTTGCCCACA
GCCTTTACCCA -> CCTTTACCCAT
GCGAAAACTAT -> CGAAAACTATC
GCGAAAGCGAA -> CGAAAGCGAAC
GCGAACACCTA -> CGAACACCTAA
GCGAACCACGA -> CGAACCACGAG
GCGAATTGAAC -> CGAATTGAACT
GCGACACAGCC -> CGACACAGCCA
GCGACATACTC -> CGACATACTCG
GCGACATGTGG -> CGACATGTGGA
GCGAGAGTGCT -> CGAGAGTGCTT
GCGAGCATCGG -> CGAGCATCGGT
GCGAGGGCAGC -> CGAGGGCAGCT
GCGAGGGTTAT -> CGAGGGTTATG
GCGAGGTGGAA -> CGAGGTGGAAG
GCGAGTCGCGA -> CGAGTCGCGAC
GCGATGCTTTC -> CGATGCTTTCT
GCGATTACCCC -> CGATTACCCCG
GCGCATCGTTG -> CGCATCGTTGT
GCGCATGCAGG -> CGCATGCAGGG
GCGCCCCTTAT -> CGCCCCTTATA
GCGCCTCTTTG -> CGCCTCTTTGC
GCGCGAGCATC -> CGCGAGCATCG
GCGCGGAGCCG -> CGCGGAGCCGA
GCGCTGACGAG -> CGCTGACGAGT
GCGCTTTAGGA -> CGCTTTAGGAA
GCGGAAGGGCG -> CGGAAGGGCGA
GCGGAGCCGAT -> CGGAGCCGATT
GCGGATACGTG -> CGGATACGTGC
GCGGCGCATCG -> CGGCGCATCGT
GCGGGTATGTT -> CGGGTATGTTC
GCGTACAATAC -> CGTACAATACG
GCGTATAATCA -> CGTATAATCAC
GCGTCAGATAA -> CGTCAGATAAA
GCGTCAGGGGC -> CGTCAGGGGCT
GCGTTGAGACT -> CGTTGAGACTT
GCTAAAAAAAA -> CTAAAAAAAAC
GCTAAAAAAGA -> CTAAAAAAGAA
GCTAAAAGCAT -> CTAAAAGCATG
GCTACAATGTC -> CTACAATGTCC
GCTACACGCTA -> CTACACGCTAG
GCTACGGTCGT -> CTACGGTCGTC
GCTACGTCTTA -> CTACGTCTTAT
GCTACGTTTCG -> CTACGTTTCGA
GCTACTTGAGA -> CTACTTGAGAG
GCTAGAGCGCC -> CTAGAGCGCCT
GCTAGTCGCGA -> CTAGTCGCGAT
GCTATCGGTGT -> CTATCGGTGTT
GCTCACAAACT -> CTCACAAACTT
GCTCACACTAT -> CTCACACTATG
GCTCAGCTGAA -> CTCAGCTGAAA
GCTCCTAGGGA -> CTCCTAGGGAC
GCTCGCCTTTA -> CTCGCCTTTAC
GCTCTCGTTTG -> CTCTCGTTTGC
GCTCTTTCTTC -> CTCTTTCTTCT
GCTGAAACAGT -> CTGAAACAGTG
GCTGAATCAGC -> CTGAATCAGCG
GCTGACGAGTA -> CTGACGAGTAA
GCTGAGTGATT -> CTGAGTGATTT
GCTGATACAGT -> CTGATACAGTA
GCTGATTTGAT -> CTGATTTGATC
GCTGTCTTACT -> CTGTCTTACTA
GCTTACGTTGA -> CTTACGTTGAG
GCTTACTCACA -> CTTACTCACAC
GCTTCGGTGTG -> CTTCGGTGTGT
GCTTCTTAAAT -> CTTCTTAAATT
GCTTGTTCATG -> CTTGTTCATGG
GCTTTAGGAAA -> CTTTAGGAAAT
GCTTTCGGCCT -> CTTTCGGCCTT
GCTTTCTTTTC -> CTTTCTTTTCA
GCTTTTGCGGC -> CTTTTGCGGCG
GGAAATGTGTG -> GAAATGTGTGC
GGAACGAGTGC -> GAACGAGTGCG
GGAACGGTGGG -> GAACGGTGGGA
GGAAGCCCGAA -> GAAGCCCGAAG
GGAAGGGCGAA -> GAAGGGCGAAT
GGAAGTTGACG -> GAAGTTGACGT
GGAATAACAAG -> GAATAACAAGT
GGAATACGCTC -> GAATACGCTCA
GGAATATGGGA -> GAATATGGGAC
GGACACTTCGA -> GACACTTCGAA
GGACCAAAGCC -> GACCAAAGCCC
GGACCCGCTAT -> GACCCGCTATC
GGACCTTCGCG -> GACCTTCGCGC
GGACTATGTTA -> GACTATGTTAG
GGAGAAGTACG -> GAGAAGTACGC
GGAGATCCTTG -> GAGATCCTTGG
GGAGCCGATTT -> GAGCCGATTTA
GGAGGCTAAAA -> GAGGCTAAAAG
GGAGGTACGCG -> GAGGTACGCGT
GGAGGTCGGAG -> GAGGTCGGAGA
GGAGGTTTTTA -> GAGGTTTTTAT
GGAGGTTTTTG -> GAGGTTTTTGC
GGAGTACTGTG -> GAGTACTGTGC
GGATACGTGCG -> GATACGTGCGA
GGATACTGTTG -> GATACTGTTGC
GGATCTCGTTC -> GATCTCGTTCC
GGATGAACGAC -> GATGAACGACT
GGATGCACGCC -> GATGCACGCCC
GGATTCTATAT -> GATTCTATATA
GGCAACCAGAT -> GCAACCAGATT
GGCAGCGAGAG -> GCAGCGAGAGT
GGCAGCTACAC -> GCAGCTACACG
GGCAGGGCGCA -> GCAGGGCGCAT
GGCCATTCATT -> GCCATTCATTA
GGCCCATAGGG -> GCCCATAGGGG
GGCCGAGCTGA -> GCCGAGCTGAG
GGCCGGCTAAA -> GCCGGCTAAAA
GGCCGTCCAGA -> GCCGTCCAGAA
GGCCTGCAGTG -> GCCTGCAGTGT
GGCCTTCCGGC -> GCCTTCCGGCC
GGCCTTCGCGC -> GCCTTCGCGCT
GGCCTTGATTC -> GCCTTGATTCA
GGCCTTGCCCA -> GCCTTGCCCAC
GGCGAAAACTA -> GCGAAAACTAT
GGCGAAAGCGA -> GCGAAAGCGAA
GGCGAATTGAA -> GCGAATTGAAC
GGCGAGGTGGA -> GCGAGGTGGAA
GGCGATTACCC -> GCGATTACCCC
GGCGCATCGTT -> GCGCATCGTTG
GGCGCATGCAG -> GCGCATGCAGG
GGCTAAAAAAA -> GCTAAAAAAAA
GGCTAAAAGCA -> GCTAAAAGCAT
GGCTAGAGCGC -> GCTAGAGCGCC
GGCTCTCGTTT -> GCTCTCGTTTG
GGGAACGGTGG -> GGAACGGTGGG
GGGAATAACAA -> GGAATAACAAG
GGGACCAAAGC -> GGACCAAAGCC
GGGACCCGCTA -> GGACCCGCTAT
GGGACCTTCGC -> GGACCTTCGCG
GGGACTATGTT -> GGACTATGTTA
GGGAGAAGTAC -> GGAGAAGTACG
GGGATGAACGA -> GGATGAACGAC
GGGCAGCGAGA -> GGCAGCGAGAG
GGGCAGCTACA -> GGCAGCTACAC
GGGCCATTCAT -> GGCCATTCATT
GGGCCTGCAGT -> GGCCTGCAGTG
GGGCCTTCCGG -> GGCCTTCCGGC
GGGCCTTGATT -> GGCCTTGATTC
GGGCGAATTGA -> GGCGAATTGAA
GGGCGATTACC -> GGCGATTACCC
GGGCGCATGCA -> GGCGCATGCAG
GGGCTCTCGTT -> GGCTCTCGTTT
GGGGAGAAGTA -> GGGAGAAGTAC
GGGGCAGCGAG -> GGGCAGCGAGA
GGGGCCTTCCG -> GGGCCTTCCGG
GGGGCTCTCGT -> GGGCTCTCGTT
GGGGTCGTAGG -> GGGTCGTAGGT
GGGTATGTTCA -> GGTATGTTCAC
GGGTCCCCTAT -> GGTCCCCTATC
GGGTCGTAGGT -> GGTCGTAGGTA
GGGTGGCAGGG -> GGTGGCAGGGC
GGGTTATGGCC -> GGTTATGGCCC
GGGTTCCCGTT -> GGTTCCCGTTG
GGGTTGAAACT -> GGTTGAAACTG
GGTAAACTTTT -> GTAAACTTTTC
GGTAACTCACG -> GTAACTCACGT
GGTACGCCATC -> GTACGCCATCT
GGTACGCGTAC -> GTACGCGTACA
GGTATGTTCAC -> GTATGTTCACA
GGTATTTGGTG -> GTATTTGGTGA
GGTCATGAGTA -> GTCATGAGTAT
GGTCCCCTATC -> GTCCCCTATCC
GGTCCGTGAGA -> GTCCGTGAGAA
GGTCGACGATG -> GTCGACGATGA
GGTCGGAGATC -> GTCGGAGATCC
GGTCGTAGGTA -> GTCGTAGGTAA
GGTCGTCTTGG -> GTCGTCTTGGT
GGTCTGCATCT -> GTCTGCATCTC
GGTCTTCCCGA -> GTCTTCCCGAG
GGTGAGACACC -> GTGAGACACCT
GGTGGAAGTTG -> GTGGAAGTTGA
GGTGGAGGTTT -> GTGGAGGTTTT
GGTGGCAGGGC -> GTGGCAGGGCG
GGTGGGATGAA -> GTGGGATGAAC
GGTGGTCGACG -> GTGGTCGACGA
GGTGTATCCTC -> GTGTATCCTCT
GGTGTGTCACG -> GTGTGTCACGA
GGTGTTTATAA -> GTGTTTATAAA
GGTTAATACAA -> GTTAATACAAA
GGTTAGAATGT -> GTTAGAATGTC
GGTTATGGCCC -> GTTATGGCCCA
GGTTCCCGTTG -> GTTCCCGTTGG
GGTTGAAACTG -> GTTGAAACTGT
GGTTTCACCAC -> GTTTCACCACT
GGTTTTTATCA -> GTTTTTATCAC
GGTTTTTGCTG -> GTTTTTGCTGA
GGTTTTTGGAG -> GTTTTTGGAGT
GTAAACTTTTC -> TAAACTTTTCA
GTAAATAAGCT -> TAAATAAGCTC
GTAACTCACGT -> TAACTCACGTT
GTAAGATTTTA -> TAAGATTTTAT
GTACAATACGT -> TACAATACGTT
GTACCATAGCG -> TACCATAGCGT
GTACGCCATCT -> TACGCCATCTC
GTACGCCTCAA -> TACGCCTCAAT
GTACGCGTACA -> TACGCGTACAA
GTACTACGAGA -> TACTACGAGAG
GTACTGTGCAT -> TACTGTGCATC
GTAGAAATGTT -> TAGAAATGTTC
GTAGAATGGGT -> TAGAATGGGTT
GTAGACTCCCC -> TAGACTCCCCA
GTAGGGCCTTG -> TAGGGCCTTGA
GTAGGTAAACT -> TAGGTAAACTT
GTATAATCACT -> TATAATCACTG
GTATAGAACGC -> TATAGAACGCT
GTATCCTCTGC -> TATCCTCTGCA
GTATCGGATCT -> TATCGGATCTC
GTATGCCGGCG -> TATGCCGGCGA
GTATGTTCACA -> TATGTTCACAG
GTATTTGGTGA -> TATTTGGTGAG
GTCAACCATCT -> TCAACCATCTT
GTCAAGCACCC -> TCAAGCACCCG
GTCACGATTCA -> TCACGATTCAG
GTCAGAGCCGC -> TCAGAGCCGCG
GTCAGATAAAA -> TCAGATAAAAT
GTCAGGGGCTC -> TCAGGGGCTCT
GTCATGAGTAT -> TCATGAGTATG
GTCCAGAACCG -> TCCAGAACCGT
GTCCAGTTCGC -> TCCAGTTCGCA
GTCCCCGCTTT -> TCCCCGCTTTC
GTCCCCTATCC -> TCCCCTATCCA
GTCCGGGGCCT -> TCCGGGGCCTT
GTCCGTGAGAA -> TCCGTGAGAAG
GTCGACGATGA -> TCGACGATGAC
GTCGCGACATA -> TCGCGACATAC
GTCGCGATGCT -> TCGCGATGCTT
GTCGGAGATCC -> TCGGAGATCCT
GTCGTAGGTAA -> TCGTAGGTAAA
GTCGTCTTGGT -> TCGTCTTGGTT
GTCGTTGTCTT -> TCGTTGTCTTC
GTCTATCCTTG -> TCTATCCTTGC
GTCTCAGCTAC -> TCTCAGCTACG
GTCTGAGGAGG -> TCTGAGGAGGC
GTCTGCATCTC -> TCTGCATCTCT
GTCTTAAACGC -> TCTTAAACGCA
GTCTTACTAAT -> TCTTACTAATT
GTCTTATACAT -> TCTTATACATG
GTCTTCCATGC -> TCTTCCATGCG
GTCTTCCCGAG -> TCTTCCCGAGT
GTCTTGGTTAG -> TCTTGGTTAGA
GTGAGAAGCCC -> TGAGAAGCCCG
GTGAGACACCT -> TGAGACACCTT
GTGATTTTGCC -> TGATTTTGCCG
GTGCATCAGCA -> TGCATCAGCAG
GTGCATCCATT -> TGCATCCATTA
GTGCGAGGGCA -> TGCGAGGGCAG
GTGCGTCAGGG -> TGCGTCAGGGG
GTGCTACAATG -> TGCTACAATGT
GTGCTTTTGCG -> TGCTTTTGCGG
GTGGAAGTTGA -> TGGAAGTTGAC
GTGGAGGTACG -> TGGAGGTACGC
GTGGAGGTTTT -> TGGAGGTTTTT,TGGAGGTTTTT
GTGGCAGGGCG -> TGGCAGGGCGC
GTGGCTAGAGC -> TGGCTAGAGCG
GTGGGAATAAC -> TGGGAATAACA
GTGGGATGAAC -> TGGGATGAACG
GTGGTACGCCA -> TGGTACGCCAT
GTGGTCGACGA -> TGGTCGACGAT
GTGGTCTGCAT -> TGGTCTGCATC
GTGGTCTTCCC -> TGGTCTTCCCG
GTGTATCCTCT -> TGTATCCTCTG
GTGTCACGATT -> TGTCACGATTC
GTGTCAGAGCC -> TGTCAGAGCCG
GTGTGCATCCA -> TGTGCATCCAT
GTGTGTCACGA -> TGTGTCACGAT
GTGTTTATAAA -> TGTTTATAAAC
GTGTTTCATAC -> TGTTTCATACT
GTTAATACAAA -> TTAATACAAAG
GTTAATCGCGC -> TTAATCGCGCG
GTTACCATCTG -> TTACCATCTGA
GTTAGAATGTC -> TTAGAATGTCA
GTTAGCTACTT -> TTAGCTACTTG
GTTAGGTCATG -> TTAGGTCATGA
GTTATGGCCCA -> TTATGGCCCAT
GTTCACAGATG -> TTCACAGATGT
GTTCATGGGTG -> TTCATGGGTGG
GTTCCCAAGGA -> TTCCCAAGGAA
GTTCCCCCGAG -> TTCCCCCGAGA
GTTCCCGTTGG -> TTCCCGTTGGT
GTTCGCAGAAC -> TTCGCAGAACT
GTTCTAACAAG -> TTCTAACAAGG
GTTCTATGTGG -> TTCTATGTGGT
GTTGAAACTGT -> TTGAAACTGTG
GTTGACGACGG -> TTGACGACGGC
GTTGACGTGGT -> TTGACGTGGTC
GTTGAGAACTC -> TTGAGAACTCA
GTTGAGACTTT -> TTGAGACTTTA
GTTGCAGCTCA -> TTGCAGCTCAC
GTTGCGAGGGT -> TTGCGAGGGTT
GTTGGGACTAT -> TTGGGACTATG
GTTGGTTTCAC -> TTGGTTTCACC
GTTGTCCCCGC -> TTGTCCCCGCT
GTTGTCTTCCA -> TTGTCTTCCAT
GTTTATAAACA -> TTTATAAACAG
GTTTCACCACT -> TTTCACCACTT
GTTTCATACTG -> TTTCATACTGT
GTTTCGACTCT -> TTTCGACTCTC
GTTTGAGCTCG -> TTTGAGCTCGC
GTTTGCTTACT -> TTTGCTTACTC
GTTTGGCCGTC -> TTTGGCCGTCC
GTTTTTATCAC -> TTTTTATCACA
GTTTTTGCTGA -> TTTTTGCTGAT
GTTTTTGGAGT -> TTTTTGGAGTA
TAAAAAAAACT -> AAAAAAAACTA
TAAAAAAGAAG -> AAAAAAGAAGG
TAAAAGCATGG -> AAAAGCATGGA
TAAAATGCGAC -> AAAATGCGACA
TAAACAGTTGG -> AAACAGTTGGG
TAAACGCAGTA -> AAACGCAGTAC
TAAACTTTTCA -> AAACTTTTCAC
TAAATAAGCTC -> AAATAAGCTCA
TAAATCAGGTG -> AAATCAGGTGT
TAAATTGCATA -> AAATTGCATAT
TAACAAGGCCG -> AACAAGGCCGG
TAACAAGTGGT -> AACAAGTGGTA
TAACTCACGTT -> AACTCACGTTG
TAAGACGAAGT -> AAGACGAAGTC
TAAGATGATCG -> AAGATGATCGT
TAAGATTTTAT -> AAGATTTTATA
TAAGCTCACAC -> AAGCTCACACT
TAAGCTGAATC -> AAGCTGAATCA
TAAGGCCGAGC -> AAGGCCGAGCT
TAAGGGACCTT -> AAGGGACCTTC
TAAGGTGGTCG -> AAGGTGGTCGA
TAATAAGGGAC -> AATAAGGGACC
TAATACAAAGC -> AATACAAAGCT
TAATACGAGTA -> AATACGAGTAG
TAATCACTGTT -> AATCACTGTTA
TAATCGCGCGA -> AATCGCGCGAG
TAATTAGAGCT -> AATTAGAGCTA
TACAAAGCTTC -> ACAAAGCTTCT
TACAATACGTT -> ACAATACGTTA
TACAATGTCCA -> ACAATGTCCAG
TACACGCTAGT -> ACACGCTAGTC
TACAGGGCCAT -> ACAGGGCCATT
TACAGTATCGG -> ACAGTATCGGA
TACAGTTCTAT -> ACAGTTCTATG
TACATGCAGCA -> ACATGCAGCAA
TACCATAGCGT -> ACCATAGCGTT
TACCATCTGAT -> ACCATCTGATA
TACCCATTTAT -> ACCCATTTATA
TACCCCAACGT -> ACCCCAACGTC
TACCCCGGTAT -> ACCCCGGTATT
TACCGAGATTG -> ACCGAGATTGG
TACCTATCGAG -> ACCTATCGAGG
TACGAGAGCAT -> ACGAGAGCATA
TACGAGTAGAA -> ACGAGTAGAAT
TACGCCATCTC -> ACGCCATCTCA
TACGCCTCAAT -> ACGCCTCAATC
TACGCGTACAA -> ACGCGTACAAT
TACGCTCAGCT -> ACGCTCAGCTG
TACGGTCGTCT -> ACGGTCGTCTT
TACGTCTTATA -> ACGTCTTATAC
TACGTGCGAGG -> ACGTGCGAGGG
TACGTTAGCTA -> ACGTTAGCTAC
TACGTTGAGAA -> ACGTTGAGAAC
TACGTTTCGAC -> ACGTTTCGACT
TACTAATTAGA -> ACTAATTAGAG
TACTACGAGAG -> ACTACGAGAGC
TACTCACACCC -> ACTCACACCCG
TACTCGAACCC -> ACTCGAACCCA
TACTGTAAATA -> ACTGTAAATAA
TACTGTGCATC -> ACTGTGCATCA
TACTGTTGCGA -> ACTGTTGCGAG
TACTTGAGAGT -> ACTTGAGAGTA
TAGAAATGCTA -> AGAAATGCTAC
TAGAAATGTTC -> AGAAATGTTCT
TAGAACGCTGA -> AGAACGCTGAT
TAGAAGTCGTT -> AGAAGTCGTTG
TAGAATGGGTT -> AGAATGGGTTG
TAGAATGTCAA -> AGAATGTCAAC
TAGACTCCCCA -> AGACTCCCCAG
TAGAGCGCCTC -> AGAGCGCCTCT
TAGAGCTAAAA -> AGAGCTAAAAA
TAGATAGAAGT -> AGATAGAAGTC
TAGCAAATCGA -> AGCAAATCGAG
TAGCGTTGAGA -> AGCGTTGAGAC
TAGCTACTTGA -> AGCTACTTGAG
TAGCTTACGTT -> AGCTTACGTTG
TAGCTTCGGTG -> AGCTTCGGTGT
TAGGAAATGTG -> AGGAAATGTGT
TAGGATACTGT -> AGGATACTGTT
TAGGGACCCGC -> AGGGACCCGCT
TAGGGCCTTGA -> AGGGCCTTGAT
TAGGGGAGAAG -> AGGGGAGAAGT
TAGGGGTCGTA -> AGGGGTCGTAG
TAGGGTTCCCG -> AGGGTTCCCGT
TAGGTAAACTT -> AGGTAAACTTT
TAGGTCATGAG -> AGGTCATGAGT
TAGGTGGAGGT -> AGGTGGAGGTT
TAGTCGCGATG -> AGTCGCGATGC
TAGTGGCTAGA -> AGTGGCTAGAG
TATAAACAGTT -> ATAAACAGTTG
TATAAGATGAT -> ATAAGATGATC
TATAATCACTG -> ATAATCACTGT
TATACATGCAG -> ATACATGCAGC
TATACCCCAAC -> ATACCCCAACG
TATACCTATCG -> ATACCTATCGA
TATAGAAATGC -> ATAGAAATGCT
TATAGAACGCT -> ATAGAACGCTG
TATAGGATACT -> ATAGGATACTG
TATATATATTA -> ATATATATTAT
TATATATTATA -> ATATATTATAA
TATATTATAAG -> ATATTATAAGA
TATCACAATCG -> ATCACAATCGG
TATCACACAGT -> ATCACACAGTG
TATCACATGGA -> ATCACATGGAT
TATCCAACGTC -> ATCCAACGTCT
TATCCTCTGCA -> ATCCTCTGCAT
TATCCTTGCCC -> ATCCTTGCCCT
TATCGAGGGTC -> ATCGAGGGTCC
TATCGGATCTC -> ATCGGATCTCG
TATCGGTGTTT -> ATCGGTGTTTA
TATCTCGCAGT -> ATCTCGCAGTA
TATCTTGAGCT -> ATCTTGAGCTG
TATGCCGGCGA -> ATGCCGGCGAA
TATGCGGGTAT -> ATGCGGGTATG
TATGGATTCTA -> ATGGATTCTAT
TATGGCCCATA -> ATGGCCCATAG
TATGGGACCAA -> ATGGGACCAAA
TATGTAGACTC -> ATGTAGACTCC
TATGTGGTCTG -> ATGTGGTCTGC
TATGTTAGGTC -> ATGTTAGGTCA
TATGTTCACAG -> ATGTTCACAGA
TATTATAAGAT -> ATTATAAGATG
TATTATGCGGG -> ATTATGCGGGT
TATTTGGTGAG -> ATTTGGTGAGA
TCAACCATCTT -> CAACCATCTTG
TCAAGCACCCG -> CAAGCACCCGG
TCAATCGGACA -> CAATCGGACAC
TCACAAACTTG -> CACAAACTTGA
TCACAATCGGA -> CACAATCGGAA
TCACACAGTGG -> CACACAGTGGA
TCACACCCGCA -> CACACCCGCAG
TCACACTATGT -> CACACTATGTA
TCACAGATGTG -> CACAGATGTGC
TCACAGTTGCA -> CACAGTTGCAG
TCACATGGATG -> CACATGGATGC
TCACCACTTGT -> CACCACTTGTC
TCACCCAACGG -> CACCCAACGGG
TCACCGCCCAA -> CACCGCCCAAG
TCACGATTCAG -> CACGATTCAGC
TCACGCATGAT -> CACGCATGATC
TCACGCCTTAA -> CACGCCTTAAT
TCACGTTGACG -> CACGTTGACGA
TCACTAGATAG -> CACTAGATAGA
TCACTGTTACC -> CACTGTTACCA
TCAGACGATCC -> CAGACGATCCA
TCAGAGCCGCG -> CAGAGCCGCGT
TCAGATAAAAT -> CAGATAAAATG
TCAGCAGCGAC -> CAGCAGCGACA
TCAGCCCCCGG -> CAGCCCCCGGG
TCAGCGCCCCT -> CAGCGCCCCTT
TCAGCTACGGT -> CAGCTACGGTC
TCAGCTGAAAC -> CAGCTGAAACA
TCAGGGGCTCT -> CAGGGGCTCTC
TCAGGTGTATC -> CAGGTGTATCC
TCATACTGTAA -> CATACTGTAAA
TCATAGTGGCT -> CATAGTGGCTA
TCATGACCACA -> CATGACCACAG
TCATGAGTATG -> CATGAGTATGC
TCATGGGTGGC -> CATGGGTGGCA
TCATTAGCTTA -> CATTAGCTTAC
TCCAACGTCTA -> CCAACGTCTAT
TCCAACTATTA -> CCAACTATTAT
TCCAAGTCTTA -> CCAAGTCTTAA
TCCAGAACCGT -> CCAGAACCGTC
TCCAGCCAGGT -> CCAGCCAGGTC
TCCAGTTCGCA -> CCAGTTCGCAG
TCCATGCGGAA -> CCATGCGGAAG
TCCATTAAATC -> CCATTAAATCA
TCCCAAGGAAC -> CCCAAGGAACG
TCCCCAGGAGG -> CCCCAGGAGGT
TCCCCCGAGAC -> CCCCCGAGACG
TCCCCGCTTTC -> CCCCGCTTTCG
TCCCCTATCCA -> CCCCTATCCAA
TCCCGAGTTAA -> CCCGAGTTAAT
TCCCGTTGGTT -> CCCGTTGGTTT
TCCGACTTACC -> CCGACTTACCG
TCCGGCCTTGC -> CCGGCCTTGCC
TCCGGGGCCTT -> CCGGGGCCTTC
TCCGTGAGAAG -> CCGTGAGAAGC
TCCTAGGGACC -> CCTAGGGACCC
TCCTCTGCATG -> CCTCTGCATGC
TCCTTGCCCTC -> CCTTGCCCTCC
TCCTTGGCAAC -> CCTTGGCAACC
TCGAAAACTCG -> CGAAAACTCGT
TCGAACCCATT -> CGAACCCATTA
TCGACGATGAC -> CGACGATGACT
TCGACTCTCAT -> CGACTCTCATG
TCGAGCTCTTT -> CGAGCTCTTTC
TCGAGGGTCCC -> CGAGGGTCCCC
TCGCAGAACTA -> CGCAGAACTAC
TCGCAGTACCA -> CGCAGTACCAT
TCGCCTTTACC -> CGCCTTTACCC
TCGCGACATAC -> CGCGACATACT
TCGCGATGCTT -> CGCGATGCTTT
TCGCGCGAGCA -> CGCGCGAGCAT
TCGCGCTGACG -> CGCGCTGACGA
TCGCGCTTTAG -> CGCGCTTTAGG
TCGGAAGCCCG -> CGGAAGCCCGA
TCGGACACTTC -> CGGACACTTCG
TCGGAGATCCT -> CGGAGATCCTT
TCGGATCTCGT -> CGGATCTCGTT
TCGGCCTTCGC -> CGGCCTTCGCG
TCGGTGTGTCA -> CGGTGTGTCAC
TCGGTGTTTAT -> CGGTGTTTATA
TCGGTTAATAC -> CGGTTAATACA
TCGTAGGTAAA -> CGTAGGTAAAC
TCGTCTTGGTT -> CGTCTTGGTTA
TCGTTCCCAAG -> CGTTCCCAAGG
TCGTTCCCCCG -> CGTTCCCCCGA
TCGTTGTCCCC -> CGTTGTCCCCG
TCGTTGTCTTC -> CGTTGTCTTCC
TCGTTTGCTTA -> CGTTTGCTTAC
TCGTTTGGCCG -> CGTTTGGCCGT
TCTAACAAGGC -> CTAACAAGGCC
TCTAAGCTGAA -> CTAAGCTGAAT
TCTATACCCCA -> CTATACCCCAA
TCTATATATAT -> CTATATATATT
TCTATCCTTGC -> CTATCCTTGCC
TCTATGGATTC -> CTATGGATTCT
TCTATGTGGTC -> CTATGTGGTCT
TCTCACTAGAT -> CTCACTAGATA
TCTCAGCTACG -> CTCAGCTACGG
TCTCATGACCA -> CTCATGACCAC
TCTCGCAGTAC -> CTCGCAGTACC
TCTCGTTCCCA -> CTCGTTCCCAA
TCTCGTTTGCT -> CTCGTTTGCTT
TCTCTAAGCTG -> CTCTAAGCTGA
TCTGAGGAGGC -> CTGAGGAGGCT
TCTGATAGGGG -> CTGATAGGGGA
TCTGCATCTCT -> CTGCATCTCTA
TCTGCATGCGG -> CTGCATGCGGA
TCTGGAATACG -> CTGGAATACGC
TCTTAAACGCA -> CTTAAACGCAG
TCTTAAATTGC -> CTTAAATTGCA
TCTTACTAATT -> CTTACTAATTA
TCTTATACATG -> CTTATACATGC
TCTTCCATGCG -> CTTCCATGCGG
TCTTCCCGAGT -> CTTCCCGAGTT
TCTTCTATGGA -> CTTCTATGGAT
TCTTGAGCTGT -> CTTGAGCTGTC
TCTTGGTTAGA -> CTTGGTTAGAA
TCTTGGTTTTT -> CTTGGTTTTTG
TCTTTCTTCTA -> CTTTCTTCTAT
TCTTTGCATCA -> CTTTGCATCAC
TCTTTTCACCC -> CTTTTCACCCA
TGAAACAGTGT -> GAAACAGTGTT
TGAAACTGTGG -> GAAACTGTGGG
TGAACGACTTG -> GAACGACTTGT
TGAACTGTAGG -> GAACTGTAGGG
TGAATCAGCGC -> GAATCAGCGCC
TGAATTTCTGG -> GAATTTCTGGA
TGACCACAGAT -> GACCACAGATA
TGACGACGGCG -> GACGACGGCGA
TGACGAGTAAG -> GACGAGTAAGA
TGACGTGGTCT -> GACGTGGTCTT
TGACTTAAGGC -> GACTTAAGGCC
TGAGAACTCAC -> GAGAACTCACG
TGAGAAGCCCG -> GAGAAGCCCGG
TGAGACACCTT -> GAGACACCTTT
TGAGACTTTAA -> GAGACTTTAAG
TGAGAGTATAG -> GAGAGTATAGA
TGAGCTCGCCT -> GAGCTCGCCTT
TGAGCTGTCTT -> GAGCTGTCTTA
TGAGGAGGCTA -> GAGGAGGCTAA
TGAGTATGCCG -> GAGTATGCCGG
TGAGTGATTTT -> GAGTGATTTTG
TGATACAGTAT -> GATACAGTATC
TGATAGGGGAG -> GATAGGGGAGA
TGATCAGACGA -> GATCAGACGAT
TGATCCAGCCA -> GATCCAGCCAG
TGATCGTTTGG -> GATCGTTTGGC
TGATTCATAGT -> GATTCATAGTG
TGATTTGATCC -> GATTTGATCCA
TGATTTTGCCG -> GATTTTGCCGC
TGCACGCCCAT -> GCACGCCCATT
TGCAGCAATCA -> GCAGCAATCAC
TGCAGCTCACA -> GCAGCTCACAA
TGCAGGGCGAT -> GCAGGGCGATT
TGCAGTGTCAG -> GCAGTGTCAGA
TGCATATCACA -> GCATATCACAC
TGCATCACAGT -> GCATCACAGTT
TGCATCAGCAG -> GCATCAGCAGC
TGCATCCATTA -> GCATCCATTAA
TGCATCTCTAA -> GCATCTCTAAG
TGCATGCGGAT -> GCATGCGGATA
TGCCCACAACG -> GCCCACAACGA
TGCCCTCCAAC -> GCCCTCCAACT
TGCCGCGAACC -> GCCGCGAACCA
TGCCGGCGAAA -> GCCGGCGAAAA
TGCGACACAGC -> GCGACACAGCC
TGCGAGGGCAG -> GCGAGGGCAGC
TGCGAGGGTTA -> GCGAGGGTTAT
TGCGGAAGGGC -> GCGGAAGGGCG
TGCGGATACGT -> GCGGATACGTG
TGCGGCGCATC -> GCGGCGCATCG
TGCGGGTATGT -> GCGGGTATGTT
TGCGTATAATC -> GCGTATAATCA
TGCGTCAGGGG -> GCGTCAGGGGC
TGCTACAATGT -> GCTACAATGTC
TGCTACGTCTT -> GCTACGTCTTA
TGCTCCTAGGG -> GCTCCTAGGGA
TGCTGATACAG -> GCTGATACAGT
TGCTTACTCAC -> GCTTACTCACA
TGCTTTCTTTT -> GCTTTCTTTTC
TGCTTTTGCGG -> GCTTTTGCGGC
TGGAAGTTGAC -> GGAAGTTGACG
TGGAATACGCT -> GGAATACGCTC
TGGAATATGGG -> GGAATATGGGA
TGGAGGTACGC -> GGAGGTACGCG
TGGAGGTTTTT -> GGAGGTTTTTG,GGAGGTTTTTA
TGGAGTACTGT -> GGAGTACTGTG
TGGATGCACGC -> GGATGCACGCC
TGGATTCTATA -> GGATTCTATAT
TGGCAACCAGA -> GGCAACCAGAT
TGGCAGGGCGC -> GGCAGGGCGCA
TGGCCCATAGG -> GGCCCATAGGG
TGGCCGTCCAG -> GGCCGTCCAGA
TGGCTAGAGCG -> GGCTAGAGCGC
TGGGAATAACA -> GGGAATAACAA
TGGGACCAAAG -> GGGACCAAAGC
TGGGACTATGT -> GGGACTATGTT
TGGGATGAACG -> GGGATGAACGA
TGGGTGGCAGG -> GGGTGGCAGGG
TGGGTTGAAAC -> GGGTTGAAACT
TGGTAACTCAC -> GGTAACTCACG
TGGTACGCCAT -> GGTACGCCATC
TGGTCGACGAT -> GGTCGACGATG
TGGTCTGCATC -> GGTCTGCATCT
TGGTCTTCCCG -> GGTCTTCCCGA
TGGTGAGACAC -> GGTGAGACACC
TGGTTAGAATG -> GGTTAGAATGT
TGGTTTCACCA -> GGTTTCACCAC
TGGTTTTTGGA -> GGTTTTTGGAG
TGTAAATAAGC -> GTAAATAAGCT
TGTAGACTCCC -> GTAGACTCCCC
TGTAGGGCCTT -> GTAGGGCCTTG
TGTATCCTCTG -> GTATCCTCTGC
TGTCAACCATC -> GTCAACCATCT
TGTCACGATTC -> GTCACGATTCA
TGTCAGAGCCG -> GTCAGAGCCGC
TGTCCAGTTCG -> GTCCAGTTCGC
TGTCCCCGCTT -> GTCCCCGCTTT
TGTCTCAGCTA -> GTCTCAGCTAC
TGTCTTACTAA -> GTCTTACTAAT
TGTCTTCCATG -> GTCTTCCATGC
TGTGCATCAGC -> GTGCATCAGCA
TGTGCATCCAT -> GTGCATCCATT
TGTGCTACAAT -> GTGCTACAATG
TGTGGAGGTTT -> GTGGAGGTTTT
TGTGGGAATAA -> GTGGGAATAAC
TGTGGTCTGCA -> GTGGTCTGCAT
TGTGTCACGAT -> GTGTCACGATT
TGTGTGCATCC -> GTGTGCATCCA
TGTTACCATCT -> GTTACCATCTG
TGTTAGGTCAT -> GTTAGGTCATG
TGTTCACAGAT -> GTTCACAGATG
TGTTCATGGGT -> GTTCATGGGTG
TGTTCTAACAA -> GTTCTAACAAG
TGTTGCGAGGG -> GTTGCGAGGGT
TGTTTATAAAC -> GTTTATAAACA
TGTTTCATACT -> GTTTCATACTG
TGTTTGAGCTC -> GTTTGAGCTCG
TTAAACGCAGT -> TAAACGCAGTA
TTAAATCAGGT -> TAAATCAGGTG
TTAAATTGCAT -> TAAATTGCATA
TTAAGACGAAG -> TAAGACGAAGT
TTAAGGCCGAG -> TAAGGCCGAGC
TTAATAAGGGA -> TAATAAGGGAC
TTAATACAAAG -> TAATACAAAGC
TTAATCGCGCG -> TAATCGCGCGA
TTACCATCTGA -> TACCATCTGAT
TTACCCATTTA -> TACCCATTTAT
TTACCCCGGTA -> TACCCCGGTAT
TTACCGAGATT -> TACCGAGATTG
TTACGTTGAGA -> TACGTTGAGAA
TTACTAATTAG -> TACTAATTAGA
TTACTCACACC -> TACTCACACCC
TTAGAATGTCA -> TAGAATGTCAA
TTAGAGCTAAA -> TAGAGCTAAAA
TTAGCTACTTG -> TAGCTACTTGA
TTAGCTTACGT -> TAGCTTACGTT
TTAGGAAATGT -> TAGGAAATGTG
TTAGGTCATGA -> TAGGTCATGAG
TTAGGTGGAGG -> TAGGTGGAGGT
TTATAAACAGT -> TATAAACAGTT
TTATAAGATGA -> TATAAGATGAT
TTATACATGCA -> TATACATGCAG
TTATACCTATC -> TATACCTATCG
TTATAGAAATG -> TATAGAAATGC
TTATAGGATAC -> TATAGGATACT
TTATCACAATC -> TATCACAATCG
TTATCACATGG -> TATCACATGGA
TTATGCGGGTA -> TATGCGGGTAT
TTATGGCCCAT -> TATGGCCCATA
TTCACAGATGT -> TCACAGATGTG
TTCACCACTTG -> TCACCACTTGT
TTCACCCAACG -> TCACCCAACGG
TTCACGCCTTA -> TCACGCCTTAA
TTCAGCCCCCG -> TCAGCCCCCGG
TTCATACTGTA -> TCATACTGTAA
TTCATAGTGGC -> TCATAGTGGCT
TTCATGGGTGG -> TCATGGGTGGC
TTCATTAGCTT -> TCATTAGCTTA
TTCCATGCGGA -> TCCATGCGGAA
TTCCCAAGGAA -> TCCCAAGGAAC
TTCCCCCGAGA -> TCCCCCGAGAC
TTCCCGAGTTA -> TCCCGAGTTAA
TTCCCGTTGGT -> TCCCGTTGGTT
TTCCGACTTAC -> TCCGACTTACC
TTCCGGCCTTG -> TCCGGCCTTGC
TTCGAAAACTC -> TCGAAAACTCG
TTCGACTCTCA -> TCGACTCTCAT
TTCGCAGAACT -> TCGCAGAACTA
TTCGCGCTGAC -> TCGCGCTGACG
TTCGCGCTTTA -> TCGCGCTTTAG
TTCGGCCTTCG -> TCGGCCTTCGC
TTCGGTGTGTC -> TCGGTGTGTCA
TTCTAACAAGG -> TCTAACAAGGC
TTCTATATATA -> TCTATATATAT
TTCTATGGATT -> TCTATGGATTC
TTCTATGTGGT -> TCTATGTGGTC
TTCTGGAATAC -> TCTGGAATACG
TTCTTAAATTG -> TCTTAAATTGC
TTCTTCTATGG -> TCTTCTATGGA
TTCTTTTCACC -> TCTTTTCACCC
TTGAAACTGTG -> TGAAACTGTGG
TTGAACTGTAG -> TGAACTGTAGG
TTGAATTTCTG -> TGAATTTCTGG
TTGACGACGGC -> TGACGACGGCG
TTGACGTGGTC -> TGACGTGGTCT
TTGAGAACTCA -> TGAGAACTCAC
TTGAGACTTTA -> TGAGACTTTAA
TTGAGAGTATA -> TGAGAGTATAG
TTGAGCTCGCC -> TGAGCTCGCCT
TTGAGCTGTCT -> TGAGCTGTCTT
TTGATCCAGCC -> TGATCCAGCCA
TTGATTCATAG -> TGATTCATAGT
TTGCAGCTCAC -> TGCAGCTCACA
TTGCATATCAC -> TGCATATCACA
TTGCATCACAG -> TGCATCACAGT
TTGCCCACAAC -> TGCCCACAACG
TTGCCCTCCAA -> TGCCCTCCAAC
TTGCCGCGAAC -> TGCCGCGAACC
TTGCGAGGGTT -> TGCGAGGGTTA
TTGCGGCGCAT -> TGCGGCGCATC
TTGCGTATAAT -> TGCGTATAATC
TTGCTCCTAGG -> TGCTCCTAGGG
TTGCTGATACA -> TGCTGATACAG
TTGCTTACTCA -> TGCTTACTCAC
TTGGAGTACTG -> TGGAGTACTGT
TTGGCAACCAG -> TGGCAACCAGA
TTGGCCGTCCA -> TGGCCGTCCAG
TTGGGACTATG -> TGGGACTATGT
TTGGTAACTCA -> TGGTAACTCAC
TTGGTGAGACA -> TGGTGAGACAC
TTGGTTAGAAT -> TGGTTAGAATG
TTGGTTTCACC -> TGGTTTCACCA
TTGGTTTTTGG -> TGGTTTTTGGA
TTGTCCCCGCT -> TGTCCCCGCTT
TTGTCTCAGCT -> TGTCTCAGCTA
TTGTCTTCCAT -> TGTCTTCCATG
TTGTTCATGGG -> TGTTCATGGGT
TTGTTTGAGCT -> TGTTTGAGCTC
TTTAAGACGAA -> TTAAGACGAAG
TTTACCCATTT -> TTACCCATTTA
TTTAGGAAATG -> TTAGGAAATGT
TTTAGGTGGAG -> TTAGGTGGAGG
TTTATAAACAG -> TTATAAACAGT
TTTATACCTAT -> TTATACCTATC
TTTATAGAAAT -> TTATAGAAATG
TTTATCACATG -> TTATCACATGG
TTTCACCACTT -> TTCACCACTTG
TTTCACCCAAC -> TTCACCCAACG
TTTCACGCCTT -> TTCACGCCTTA
TTTCATACTGT -> TTCATACTGTA
TTTCGACTCTC -> TTCGACTCTCA
TTTCGGCCTTC -> TTCGGCCTTCG
TTTCTGGAATA -> TTCTGGAATAC
TTTCTTCTATG -> TTCTTCTATGG
TTTCTTTTCAC -> TTCTTTTCACC
TTTGAGCTCGC -> TTGAGCTCGCC
TTTGATCCAGC -> TTGATCCAGCC
TTTGCATCACA -> TTGCATCACAG
TTTGCCGCGAA -> TTGCCGCGAAC
TTTGCGGCGCA -> TTGCGGCGCAT
TTTGCTCCTAG -> TTGCTCCTAGG
TTTGCTGATAC -> TTGCTGATACA
TTTGCTTACTC -> TTGCTTACTCA
TTTGGAGTACT -> TTGGAGTACTG
TTTGGCCGTCC -> TTGGCCGTCCA
TTTGGTGAGAC -> TTGGTGAGACA
TTTTATACCTA -> TTTATACCTAT
TTTTATCACAT -> TTTATCACATG
TTTTCACCCAA -> TTTCACCCAAC
TTTTCACGCCT -> TTTCACGCCTT
TTTTGCCGCGA -> TTTGCCGCGAA
TTTTGCGGCGC -> TTTGCGGCGCA
TTTTGCTGATA -> TTTGCTGATAC
TTTTGGAGTAC -> TTTGGAGTACT
TTTTTATCACA -> TTTTATCACAT
TTTTTGCTGAT -> TTTTGCTGATA
TTTTTGGAGTA -> TTTTGGAGTAC
